--ann	ã˨
ann	ã˥
ànn	ã˨˩
ânn	ã˧˥
ānn	ã˧
ah	aʔ˩
a̍h	aʔ˥
--ai	ai˨
ai	ai˥
ái	ai˥˧
ài	ai˨˩
âi	ai˧˥
āi	ai˧
--ainn	aĩ˨
ainn	aĩ˥
áinn	aĩ˥˧
àinn	aĩ˨˩
âinn	aĩ˧˥
āinn	aĩ˧
--iau	ɪaʊ˨
iau	ɪaʊ˥
iáu	ɪaʊ˥˧
iàu	ɪaʊ˨˩
iâu	ɪaʊ˧˥
iāu	ɪaʊ˧
--jainn	ʑaĩ˨
jainn	ʑaĩ˥
jáinn	ʑaĩ˥˧
jàinn	ʑaĩ˨˩
jâinn	ʑaĩ˧˥
jāinn	ʑaĩ˧
--jiai	ʑai˨
jiai	ʑai˥
jiái	ʑai˥˧
jiài	ʑai˨˩
jiâi	ʑai˧˥
jiāi	ʑai˧
--jiau	ʑɪaʊ˨
jiau	ʑɪaʊ˥
jiáu	ʑɪaʊ˥˧
jiàu	ʑɪaʊ˨˩
jiâu	ʑɪaʊ˧˥
jiāu	ʑɪaʊ˧
--jiau	ʑɪaʊ˨
jiau	ʑɪaʊ˥
jiáu	ʑɪaʊ˥˧
jiàu	ʑɪaʊ˨˩
jiâu	ʑɪaʊ˧˥
jiāu	ʑɪaʊ˧
ak	ak˩
a̍k	ak˥
--am	am˨
am	am˥
ám	am˥˧
àm	am˨˩
âm	am˧˥
ām	am˧
ap	ap˩
a̍p	ap˥
--siau	ɕɪaʊ˨
siau	ɕɪaʊ˥
siáu	ɕɪaʊ˥˧
siáu	ɕɪaʊ˥˧
siàu	ɕɪaʊ˨˩
siâu	ɕɪaʊ˧˥
siāu	ɕɪaʊ˧
at	at˩
a̍t	at˥
--au	au˨
au	au˥
áu	au˥˧
àu	au˨˩
âu	au˧˥
āu	au˧
--ba	ba˨
ba	ba˥
bá	ba˥˧
bà	ba˨˩
bâ	ba˧˥
bā	ba˧
--bann	bã˨
bann	bã˥
bánn	bã˥˧
bànn	bã˨˩
bânn	bã˧˥
bānn	bã˧
bah	baʔ˩
ba̍h	baʔ˥
--biau	bɪaʊ˨
biau	bɪaʊ˥
biáu	bɪaʊ˥˧
biàu	bɪaʊ˨˩
biâu	bɪaʊ˧˥
biāu	bɪaʊ˧
--bai	bai˨
bai	bai˥
bái	bai˥˧
bài	bai˨˩
bâi	bai˧˥
bāi	bai˧
--bainn	baĩ˨
bainn	baĩ˥
báinn	baĩ˥˧
bàinn	baĩ˨˩
bâinn	baĩ˧˥
bāinn	baĩ˧
bak	bak˩
ba̍k	bak˥
--bam	bam˨
bam	bam˥
bám	bam˥˧
bàm	bam˨˩
bâm	bam˧˥
bām	bam˧
bap	bap˩
ba̍p	bap˥
bat	bat˩
ba̍t	bat˥
--bau	bau˨
bau	bau˥
báu	bau˥˧
bàu	bau˨˩
bâu	bau˧˥
bāu	bau˧
--bir	bɨ˨
bir	bɨ˥
bír	bɨ˥˧
bìr	bɨ˨˩
bîr	bɨ˧˥
bīr	bɨ˧
--be	be˨
be	be˥
bé	be˥˧
bè	be˨˩
bê	be˧˥
bē	be˧
--benn	bẽ˨
benn	bẽ˥
bénn	bẽ˥˧
bènn	bẽ˨˩
bênn	bẽ˧˥
bēnn	bẽ˧
--bio	bɪə˨
bio	bɪə˥
bió	bɪə˥˧
biò	bɪə˨˩
biô	bɪə˧˥
biō	bɪə˧
--bo	bə˨
bo	bə˥
bó	bə˥˧
bò	bə˨˩
bô	bə˧˥
bō	bə˧
--bian	bɪɛn˨
bian	bɪɛn˥
bián	bɪɛn˥˧
biàn	bɪɛn˨˩
biân	bɪɛn˧˥
biān	bɪɛn˧
--bi	bi˨
bi	bi˥
bí	bi˥˧
bì	bi˨˩
bî	bi˧˥
bī	bi˧
--binn	bĩ˨
binn	bĩ˥
bínn	bĩ˥˧
bìnn	bĩ˨˩
bînn	bĩ˧˥
bīnn	bĩ˧
--bim	bim˨
bim	bim˥
bím	bim˥˧
bìm	bim˨˩
bîm	bim˧˥
bīm	bim˧
--bin	bin˨
bin	bin˥
bín	bin˥˧
bìn	bin˨˩
bîn	bin˧˥
bīn	bin˧
--bing	biŋ˨
bing	biŋ˥
bíng	biŋ˥˧
bìng	biŋ˨˩
bîng	biŋ˧˥
bīng	biŋ˧
bit	bit˩
bi̍t	bit˥
--biu	biu˨
biu	biu˥
biú	biu˥˧
biù	biu˨˩
biû	biu˧˥
biū	biu˧
--biunn	biũ˨
biunn	biũ˥
bíúnn	biũ˥˧
bìùnn	biũ˨˩
bîûnn	biũ˧˥
bīūnn	biũ˧
bik	bɪk˩
bi̍k	bɪk˥
--bo	bo˨
bo	bo˥
bó	bo˥˧
bò	bo˨˩
bô	bo˧˥
bō	bo˧
--boo	bɔ˨
boo	bɔ˥
bóo	bɔ˥˧
bòo	bɔ˨˩
bôo	bɔ˧˥
bōo	bɔ˧
--bonn	bɔ̃˨
bonn	bɔ̃˥
bónn	bɔ̃˥˧
bònn	bɔ̃˨˩
bônn	bɔ̃˧˥
bōnn	bɔ̃˧
bok	bɔk˩
bo̍k	bɔk˥
--bong	bɔŋ˨
bong	bɔŋ˥
bóng	bɔŋ˥˧
bòng	bɔŋ˨˩
bông	bɔŋ˧˥
bōng	bɔŋ˧
--bua	bua˨
bua	bua˥
buá	bua˥˧
buà	bua˨˩
buâ	bua˧˥
buā	bua˧
--buai	buai˨
buai	buai˥
buái	buai˥˧
buài	buai˨˩
buâi	buai˧˥
buāi	buai˧
--buan	buan˨
buan	buan˥
buán	buan˥˧
buàn	buan˨˩
buân	buan˧˥
buān	buan˧
--bu	bu˨
bu	bu˥
bú	bu˥˧
bù	bu˨˩
bû	bu˧˥
bū	bu˧
--bue	bue˨
bue	bue˥
bué	bue˥˧
buè	bue˨˩
buê	bue˧˥
buē	bue˧
--jai	dzai˨
jai	dzai˥
jái	dzai˥˧
jài	dzai˨˩
jâi	dzai˧˥
jāi	dzai˧
--jainn	dzaĩ˨
jainn	dzaĩ˥
jáinn	dzaĩ˥˧
jàinn	dzaĩ˨˩
jâinn	dzaĩ˧˥
jāinn	dzaĩ˧
jah	dzaʔ˩
ja̍h	dzaʔ˥
--ja	dza˨
ja	dza˥
já	dza˥˧
jà	dza˨˩
jâ	dza˧˥
jā	dza˧
--jann	dzã˨
jann	dzã˥
jánn	dzã˥˧
jànn	dzã˨˩
jânn	dzã˧˥
jānn	dzã˧
jak	dzak˩
ja̍k	dzak˥
--jam	dzam˨
jam	dzam˥
jám	dzam˥˧
jàm	dzam˨˩
jâm	dzam˧˥
jām	dzam˧
jap	dzap˩
ja̍p	dzap˥
jat	dzat˩
ja̍t	dzat˥
--jau	dzau˨
jau	dzau˥
jáu	dzau˥˧
jàu	dzau˨˩
jâu	dzau˧˥
jāu	dzau˧
--je	dze˨
je	dze˥
jé	dze˥˧
jè	dze˨˩
jê	dze˧˥
jē	dze˧
--jenn	dzẽ˨
jenn	dzẽ˥
jénn	dzẽ˥˧
jènn	dzẽ˨˩
jênn	dzẽ˧˥
jēnn	dzẽ˧
--jo	dzə˨
jo	dzə˥
jó	dzə˥˧
jò	dzə˨˩
jô	dzə˧˥
jō	dzə˧
--jng	dzŋ̍˨
jng	dzŋ̍˥
jng	dzŋ̍˥˧
jng	dzŋ̍˨˩
jng	dzŋ̍˧˥
jng	dzŋ̍˧
--jo	dzo˨
jo	dzo˥
jó	dzo˥˧
jò	dzo˨˩
jô	dzo˧˥
jō	dzo˧
--joo	dzɔ˨
joo	dzɔ˥
jóo	dzɔ˥˧
jòo	dzɔ˨˩
jôo	dzɔ˧˥
jōo	dzɔ˧
--jonn	dzɔ̃˨
jonn	dzɔ̃˥
jónn	dzɔ̃˥˧
jònn	dzɔ̃˨˩
jônn	dzɔ̃˧˥
jōnn	dzɔ̃˧
jok	dzɔk˩
jo̍k	dzɔk˥
--jong	dzɔŋ˨
jong	dzɔŋ˥
jóng	dzɔŋ˥˧
jòng	dzɔŋ˨˩
jông	dzɔŋ˧˥
jōng	dzɔŋ˧
--juai	dzuai˨
juai	dzuai˥
juái	dzuai˥˧
juài	dzuai˨˩
juâi	dzuai˧˥
juāi	dzuai˧
--jua	dzua˨
jua	dzua˥
juá	dzua˥˧
juà	dzua˨˩
juâ	dzua˧˥
juā	dzua˧
--juan	dzuan˨
juan	dzuan˥
juán	dzuan˥˧
juàn	dzuan˨˩
juân	dzuan˧˥
juān	dzuan˧
--jue	dzue˨
jue	dzue˥
jué	dzue˥˧
juè	dzue˨˩
juê	dzue˧˥
juē	dzue˧
--ju	dzu˨
ju	dzu˥
jú	dzu˥˧
jù	dzu˨˩
jû	dzu˧˥
jū	dzu˧
--e	e˨
e	e˥
é	e˥˧
è	e˨˩
ê	e˧˥
ē	e˧
--enn	ẽ˨
enn	ẽ˥
énn	ẽ˥˧
ènn	ẽ˨˩
ênn	ẽ˧˥
ēnn	ẽ˧
ioh	ɪəʔ˩
io̍h	ɪəʔ˥
--io	ɪə˨
io	ɪə˥
ió	ɪə˥˧
iò	ɪə˨˩
iô	ɪə˧˥
iō	ɪə˧
--jio	ʑɪə˨
jio	ʑɪə˥
jió	ʑɪə˥˧
jiò	ʑɪə˨˩
jiô	ʑɪə˧˥
jiō	ʑɪə˧
--ian	ɪɛn˨
ian	ɪɛn˥
ián	ɪɛn˥˧
iàn	ɪɛn˨˩
iân	ɪɛn˧˥
iān	ɪɛn˧
--jian	ʑɪɛn˨
jian	ʑɪɛn˥
jián	ʑɪɛn˥˧
jiàn	ʑɪɛn˨˩
jiân	ʑɪɛn˧˥
jiān	ʑɪɛn˧
--sian	ɕɪɛn˨
sian	ɕɪɛn˥
sián	ɕɪɛn˥˧
siàn	ɕɪɛn˨˩
siân	ɕɪɛn˧˥
siān	ɕɪɛn˧
--o	ə˨
o	ə˥
ó	ə˥˧
ò	ə˨˩
ô	ə˧˥
ō	ə˧
--sio	ɕɪə˨
sio	ɕɪə˥
sió	ɕɪə˥˧
siò	ɕɪə˨˩
siô	ɕɪə˧˥
siō	ɕɪə˧
--ga	ga˨
ga	ga˥
gá	ga˥˧
gà	ga˨˩
gâ	ga˧˥
gā	ga˧
--gann	gã˨
gann	gã˥
gánn	gã˥˧
gànn	gã˨˩
gânn	gã˧˥
gānn	gã˧
gah	gaʔ˩
ga̍h	gaʔ˥
--giau	gɪaʊ˨
giau	gɪaʊ˥
giáu	gɪaʊ˥˧
giàu	gɪaʊ˨˩
giâu	gɪaʊ˧˥
giāu	gɪaʊ˧
--gai	gai˨
gai	gai˥
gái	gai˥˧
gài	gai˨˩
gâi	gai˧˥
gāi	gai˧
--gainn	gaĩ˨
gainn	gaĩ˥
gáinn	gaĩ˥˧
gàinn	gaĩ˨˩
gâinn	gaĩ˧˥
gāinn	gaĩ˧
gak	gak˩
ga̍k	gak˥
--gam	gam˨
gam	gam˥
gám	gam˥˧
gàm	gam˨˩
gâm	gam˧˥
gām	gam˧
gap	gap˩
ga̍p	gap˥
gat	gat˩
ga̍t	gat˥
--gau	gau˨
gau	gau˥
gáu	gau˥˧
gàu	gau˨˩
gâu	gau˧˥
gāu	gau˧
--ge	ge˨
ge	ge˥
gé	ge˥˧
gè	ge˨˩
gê	ge˧˥
gē	ge˧
--genn	gẽ˨
genn	gẽ˥
génn	gẽ˥˧
gènn	gẽ˨˩
gênn	gẽ˧˥
gēnn	gẽ˧
--gio	gɪə˨
gio	gɪə˥
gió	gɪə˥˧
giò	gɪə˨˩
giô	gɪə˧˥
giō	gɪə˧
gioh	gɪəʔ˩
gio̍h	gɪəʔ˥
--go	gə˨
go	gə˥
gó	gə˥˧
gò	gə˨˩
gô	gə˧˥
gō	gə˧
--gian	gɪɛn˨
gian	gɪɛn˥
gián	gɪɛn˥˧
giàn	gɪɛn˨˩
giân	gɪɛn˧˥
giān	gɪɛn˧
--gir	gɨ˨
gir	gɨ˥
gír	gɨ˥˧
gìr	gɨ˨˩
gîr	gɨ˧˥
gīr	gɨ˧
--gi	gi˨
gi	gi˥
gí	gi˥˧
gì	gi˨˩
gî	gi˧˥
gī	gi˧
--ginn	gĩ˨
ginn	gĩ˥
gínn	gĩ˥˧
gìnn	gĩ˨˩
gînn	gĩ˧˥
gīnn	gĩ˧
--gim	gim˨
gim	gim˥
gím	gim˥˧
gìm	gim˨˩
gîm	gim˧˥
gīm	gim˧
--ging	giŋ˨
ging	giŋ˥
gíng	giŋ˥˧
gìng	giŋ˨˩
gîng	giŋ˧˥
gīng	giŋ˧
--gin	gin˨
gin	gin˥
gín	gin˥˧
gìn	gin˨˩
gîn	gin˧˥
gīn	gin˧
giô	giu˧˥
giō	giu˧
--giu	giu˨
giu	giu˥
giú	giu˥˧
giù	giu˨˩
--giunn	giũ˨
giunn	giũ˥
gíúnn	giũ˥˧
gìùnn	giũ˨˩
gîûnn	giũ˧˥
gīūnn	giũ˧
gik	gɪk˩
gi̍k	gɪk˥
--gng	gŋ̍˨
gng	gŋ̍˥
gng	gŋ̍˥˧
gng	gŋ̍˨˩
gng	gŋ̍˧˥
gng	gŋ̍˧
--go	go˨
go	go˥
gó	go˥˧
gò	go˨˩
gô	go˧˥
gō	go˧
--goo	gɔ˨
goo	gɔ˥
góo	gɔ˥˧
gòo	gɔ˨˩
gôo	gɔ˧˥
gōo	gɔ˧
--gonn	gɔ̃˨
gonn	gɔ̃˥
gónn	gɔ̃˥˧
gònn	gɔ̃˨˩
gônn	gɔ̃˧˥
gōnn	gɔ̃˧
giok	gɪɔk˩
gio̍k	gɪɔk˥
gok	gɔk˩
go̍k	gɔk˥
--giong	gɪɔŋ˨
giong	gɪɔŋ˥
gióng	gɪɔŋ˥˧
giòng	gɪɔŋ˨˩
giông	gɪɔŋ˧˥
giōng	gɪɔŋ˧
--gong	gɔŋ˨
gong	gɔŋ˥
góng	gɔŋ˥˧
gòng	gɔŋ˨˩
gông	gɔŋ˧˥
gōng	gɔŋ˧
--gua	gua˨
gua	gua˥
guá	gua˥˧
guà	gua˨˩
guâ	gua˧˥
guā	gua˧
--guai	guai˨
guai	guai˥
guái	guai˥˧
guài	guai˨˩
guâi	guai˧˥
guāi	guai˧
--guan	guan˨
guan	guan˥
guán	guan˥˧
guàn	guan˨˩
guân	guan˧˥
guān	guan˧
--gue	gue˨
gue	gue˥
gué	gue˥˧
guè	gue˨˩
guê	gue˧˥
guē	gue˧
--gu	gu˨
gu	gu˥
gú	gu˥˧
gù	gu˨˩
gû	gu˧˥
gū	gu˧
--ha	ha˨
ha	ha˥
há	ha˥˧
hà	ha˨˩
hâ	ha˧˥
hā	ha˧
--hann	hã˨
hann	hã˥
hánn	hã˥˧
hànn	hã˨˩
hânn	hã˧˥
hānn	hã˧
hah	haʔ˩
ha̍h	haʔ˥
--hiau	hɪaʊ˨
hiau	hɪaʊ˥
hiáu	hɪaʊ˥˧
hiàu	hɪaʊ˨˩
hiâu	hɪaʊ˧˥
hiāu	hɪaʊ˧
--hai	hai˨
hai	hai˥
hái	hai˥˧
hài	hai˨˩
hâi	hai˧˥
hāi	hai˧
--hainn	haĩ˨
hainn	haĩ˥
háinn	haĩ˥˧
hàinn	haĩ˨˩
hâinn	haĩ˧˥
hāinn	haĩ˧
hak	hak˩
ha̍k	hak˥
--ham	ham˨
ham	ham˥
hám	ham˥˧
hàm	ham˨˩
hâm	ham˧˥
hām	ham˧
hap	hap˩
ha̍p	hap˥
hat	hat˩
ha̍t	hat˥
--hau	hau˨
hau	hau˥
háu	hau˥˧
hàu	hau˨˩
hâu	hau˧˥
hāu	hau˧
--he	he˨
he	he˥
hé	he˥˧
hè	he˨˩
hê	he˧˥
hē	he˧
--henn	hẽ˨
henn	hẽ˥
hénn	hẽ˥˧
hènn	hẽ˨˩
hênn	hẽ˧˥
hēnn	hẽ˧
hioh	hɪəʔ˩
hio̍h	hɪəʔ˥
--hio	hɪə˨
hio	hɪə˥
hió	hɪə˥˧
hiò	hɪə˨˩
hiô	hɪə˧˥
hiō	hɪə˧
--ho	hə˨
ho	hə˥
hó	hə˥˧
hò	hə˨˩
hô	hə˧˥
hō	hə˧
--hian	hɪɛn˨
hian	hɪɛn˥
hián	hɪɛn˥˧
hiàn	hɪɛn˨˩
hiân	hɪɛn˧˥
hiān	hɪɛn˧
--hir	hɨ˨
hir	hɨ˥
hír	hɨ˥˧
hìr	hɨ˨˩
hîr	hɨ˧˥
hīr	hɨ˧
--hi	hi˨
hi	hi˥
hí	hi˥˧
hì	hi˨˩
hî	hi˧˥
hī	hi˧
--hinn	hĩ˨
hinn	hĩ˥
hínn	hĩ˥˧
hìnn	hĩ˨˩
hînn	hĩ˧˥
hīnn	hĩ˧
--him	him˨
him	him˥
hím	him˥˧
hìm	him˨˩
hîm	him˧˥
hīm	him˧
--hing	hiŋ˨
hing	hiŋ˥
híng	hiŋ˥˧
hìng	hiŋ˨˩
hîng	hiŋ˧˥
hīng	hiŋ˧
--hin	hin˨
hin	hin˥
hín	hin˥˧
hìn	hin˨˩
hîn	hin˧˥
hīn	hin˧
hip	hip˩
hi̍p	hip˥
hit	hit˩
hi̍t	hit˥
hiô	hiu˧˥
hiō	hiu˧
--hiu	hiu˨
hiu	hiu˥
hiú	hiu˥˧
hiù	hiu˨˩
--hiunn	hiũ˨
hiunn	hiũ˥
híúnn	hiũ˥˧
hìùnn	hiũ˨˩
hîûnn	hiũ˧˥
hīūnn	hiũ˧
hik	hɪk˩
hi̍k	hɪk˥
--hng	hŋ̍˨
hng	hŋ̍˥
hng	hŋ̍˥˧
hng	hŋ̍˨˩
hng	hŋ̍˧˥
hng	hŋ̍˧
--ho	ho˨
ho	ho˥
hó	ho˥˧
hò	ho˨˩
hô	ho˧˥
hō	ho˧
--hoo	hɔ˨
hoo	hɔ˥
hóo	hɔ˥˧
hòo	hɔ˨˩
hôo	hɔ˧˥
hōo	hɔ˧
--honn	hɔ̃˨
honn	hɔ̃˥
hónn	hɔ̃˥˧
hònn	hɔ̃˨˩
hônn	hɔ̃˧˥
hōnn	hɔ̃˧
hiok	hɪɔk˩
hio̍k	hɪɔk˥
hok	hɔk˩
ho̍k	hɔk˥
--hiong	hɪɔŋ˨
hiong	hɪɔŋ˥
hióng	hɪɔŋ˥˧
hiòng	hɪɔŋ˨˩
hiông	hɪɔŋ˧˥
hiōng	hɪɔŋ˧
--hong	hɔŋ˨
hong	hɔŋ˥
hóng	hɔŋ˥˧
hòng	hɔŋ˨˩
hông	hɔŋ˧˥
hōng	hɔŋ˧
--hua	hua˨
hua	hua˥
huá	hua˥˧
huà	hua˨˩
huâ	hua˧˥
huā	hua˧
--huai	huai˨
huai	huai˥
huái	huai˥˧
huài	huai˨˩
huâi	huai˧˥
huāi	huai˧
--huan	huan˨
huan	huan˥
huán	huan˥˧
huàn	huan˨˩
huân	huan˧˥
huān	huan˧
--hue	hue˨
hue	hue˥
hué	hue˥˧
huè	hue˨˩
huê	hue˧˥
huē	hue˧
--hu	hu˨
hu	hu˥
hú	hu˥˧
hù	hu˨˩
hû	hu˧˥
hū	hu˧
--siai	ɕiai˨
siai	ɕiai˥
siái	ɕiai˥˧
siài	ɕiai˨˩
siâi	ɕiai˧˥
siāi	ɕiai˧
--siainn	ɕiaĩ˨
siainn	ɕiaĩ˥
siáinn	ɕiaĩ˥˧
siàinn	ɕiaĩ˨˩
siâinn	ɕiaĩ˧˥
siāinn	ɕiaĩ˧
jiah	ʑiaʔ˩
jia̍h	ʑiaʔ˥
--jia	ʑia˨
jia	ʑia˥
jiá	ʑia˥˧
jià	ʑia˨˩
jiâ	ʑia˧˥
jiā	ʑia˧
--jiann	ʑiã˨
jiann	ʑiã˥
jiánn	ʑiã˥˧
jiànn	ʑiã˨˩
jiânn	ʑiã˧˥
jiānn	ʑiã˧
jiak	ʑiak˩
jia̍k	ʑiak˥
siak	ɕiak˩
sia̍k	ɕiak˥
--jiam	ʑiam˨
jiam	ʑiam˥
jiám	ʑiam˥˧
jiàm	ʑiam˨˩
jiâm	ʑiam˧˥
jiām	ʑiam˧
--siam	ɕiam˨
siam	ɕiam˥
siám	ɕiam˥˧
siàm	ɕiam˨˩
siâm	ɕiam˧˥
siām	ɕiam˧
jiap	ʑiap˩
jia̍p	ʑiap˥
siap	ɕiap˩
sia̍p	ɕiap˥
siah	ɕiaʔ˩
sia̍h	ɕiaʔ˥
--sia	ɕia˨
sia	ɕia˥
siá	ɕia˥˧
sià	ɕia˨˩
siâ	ɕia˧˥
siā	ɕia˧
--siann	ɕiã˨
siann	ɕiã˥
siánn	ɕiã˥˧
siànn	ɕiã˨˩
siânn	ɕiã˧˥
siānn	ɕiã˧
jiat	ʑiat˩
jia̍t	ʑiat˥
siat	ɕiat˩
sia̍t	ɕiat˥
--jie	ʑie˨
jie	ʑie˥
jié	ʑie˥˧
jiè	ʑie˨˩
jiê	ʑie˧˥
jiē	ʑie˧
--jienn	ʑiẽ˨
jienn	ʑiẽ˥
jiénn	ʑiẽ˥˧
jiènn	ʑiẽ˨˩
jiênn	ʑiẽ˧˥
jiēnn	ʑiẽ˧
--jio	ʑiə˨
jio	ʑiə˥
jió	ʑiə˥˧
jiò	ʑiə˨˩
jiô	ʑiə˧˥
jiō	ʑiə˧
--sie	ɕie˨
sie	ɕie˥
sié	ɕie˥˧
siè	ɕie˨˩
siê	ɕie˧˥
siē	ɕie˧
--sienn	ɕiẽ˨
sienn	ɕiẽ˥
siénn	ɕiẽ˥˧
siènn	ɕiẽ˨˩
siênn	ɕiẽ˧˥
siēnn	ɕiẽ˧
--sio	ɕiə˨
sio	ɕiə˥
sió	ɕiə˥˧
siò	ɕiə˨˩
siô	ɕiə˧˥
siō	ɕiə˧
--i	i˨
i	i˥
í	i˥˧
ì	i˨˩
î	i˧˥
ī	i˧
--inn	ĩ˨
inn	ĩ˥
ínn	ĩ˥˧
ìnn	ĩ˨˩
înn	ĩ˧˥
īnn	ĩ˧
--ir	ɨ˨
ir	ɨ˥
ír	ɨ˥˧
ìr	ɨ˨˩
îr	ɨ˧˥
īr	ɨ˧
--sinn	ɕiĩ˨
sinn	ɕiĩ˥
sínn	ɕiĩ˥˧
sìnn	ɕiĩ˨˩
sînn	ɕiĩ˧˥
sīnn	ɕiĩ˧
--siiunn	ɕiiũ˨
siiunn	ɕiiũ˥
sííúnn	ɕiiũ˥˧
sììùnn	ɕiiũ˨˩
sîîûnn	ɕiiũ˧˥
sīīūnn	ɕiiũ˧
--ji	ʑi˨
ji	ʑi˥
jí	ʑi˥˧
jì	ʑi˨˩
jî	ʑi˧˥
jī	ʑi˧
--im	im˨
im	im˥
ím	im˥˧
ìm	im˨˩
îm	im˧˥
īm	im˧
--jim	ʑim˨
jim	ʑim˥
jím	ʑim˥˧
jìm	ʑim˨˩
jîm	ʑim˧˥
jīm	ʑim˧
--sim	ɕim˨
sim	ɕim˥
sím	ɕim˥˧
sìm	ɕim˨˩
sîm	ɕim˧˥
sīm	ɕim˧
--ing	iŋ˨
ing	iŋ˥
íng	iŋ˥˧
ìng	iŋ˨˩
îng	iŋ˧˥
īng	iŋ˧
--jing	ʑiŋ˨
jing	ʑiŋ˥
jíng	ʑiŋ˥˧
jìng	ʑiŋ˨˩
jîng	ʑiŋ˧˥
jīng	ʑiŋ˧
--jing	ʑiŋ̍˨
jing	ʑiŋ̍˥
jíng	ʑiŋ̍˥˧
jìng	ʑiŋ̍˨˩
jîng	ʑiŋ̍˧˥
jīng	ʑiŋ̍˧
--sing	ɕiŋ˨
sing	ɕiŋ˥
síng	ɕiŋ˥˧
sìng	ɕiŋ˨˩
sîng	ɕiŋ˧˥
sīng	ɕiŋ˧
--sing	ɕiŋ̍˨
sing	ɕiŋ̍˥
síng	ɕiŋ̍˥˧
sìng	ɕiŋ̍˨˩
sîng	ɕiŋ̍˧˥
sīng	ɕiŋ̍˧
--in	in˨
in	in˥
ín	in˥˧
ìn	in˨˩
în	in˧˥
īn	in˧
--jin	ʑin˨
jin	ʑin˥
jín	ʑin˥˧
jìn	ʑin˨˩
jîn	ʑin˧˥
jīn	ʑin˧
--sin	ɕin˨
sin	ɕin˥
sín	ɕin˥˧
sìn	ɕin˨˩
sîn	ɕin˧˥
sīn	ɕin˧
--jio	ʑio˨
jio	ʑio˥
jió	ʑio˥˧
jiò	ʑio˨˩
jiô	ʑio˧˥
jiō	ʑio˧
--jioo	ʑiɔ˨
jioo	ʑiɔ˥
jióo	ʑiɔ˥˧
jiòo	ʑiɔ˨˩
jiôo	ʑiɔ˧˥
jiōo	ʑiɔ˧
--jionn	ʑiɔ̃˨
jionn	ʑiɔ̃˥
jiónn	ʑiɔ̃˥˧
jiònn	ʑiɔ̃˨˩
jiônn	ʑiɔ̃˧˥
jiōnn	ʑiɔ̃˧
jiok	ʑiɔk˩
jio̍k	ʑiɔk˥
--sio	ɕio˨
sio	ɕio˥
sió	ɕio˥˧
siò	ɕio˨˩
siô	ɕio˧˥
siō	ɕio˧
--sioo	ɕiɔ˨
sioo	ɕiɔ˥
sióo	ɕiɔ˥˧
siòo	ɕiɔ˨˩
siôo	ɕiɔ˧˥
siōo	ɕiɔ˧
--sionn	ɕiɔ̃˨
sionn	ɕiɔ̃˥
siónn	ɕiɔ̃˥˧
siònn	ɕiɔ̃˨˩
siônn	ɕiɔ̃˧˥
siōnn	ɕiɔ̃˧
ip	ip˩
pi̍p	ip˥
jip	ʑip˩
ji̍p	ʑip˥
--si	ɕi˨
si	ɕi˥
sí	ɕi˥˧
sì	ɕi˨˩
sî	ɕi˧˥
sī	ɕi˧
--sir	ɕiɨ˨
sir	ɕiɨ˥
sír	ɕiɨ˥˧
sìr	ɕiɨ˨˩
sîr	ɕiɨ˧˥
sīr	ɕiɨ˧
it	it˩
i̍t	it˥
jit	ʑit˩
ji̍t	ʑit˥
--siuan	ɕiuan˨
siuan	ɕiuan˥
siuán	ɕiuan˥˧
siuàn	ɕiuan˨˩
siuân	ɕiuan˧˥
siuān	ɕiuan˧
--siua	ɕiua˨
siua	ɕiua˥
siuá	ɕiua˥˧
siuà	ɕiua˨˩
siuâ	ɕiua˧˥
siuā	ɕiua˧
--siue	ɕiue˨
siue	ɕiue˥
siué	ɕiue˥˧
siuè	ɕiue˨˩
siuê	ɕiue˧˥
siuē	ɕiue˧
--iu	iu˨
iu	iu˥
iú	iu˥˧
iù	iu˨˩
iû	iu˧˥
iū	iu˧
--iunn	iũ˨
iunn	iũ˥
íúnn	iũ˥˧
ìùnn	iũ˨˩
îûnn	iũ˧˥
īūnn	iũ˧
jiô	ʑiu˧˥
jiō	ʑiu˧
--jiu	ʑiu˨
jiu	ʑiu˥
jiú	ʑiu˥˧
jiù	ʑiu˨˩
jiû	ʑiu˧˥
jiū	ʑiu˧
--jiu	ʑiu˨
jiu	ʑiu˥
jiú	ʑiu˥˧
jiù	ʑiu˨˩
--siu	ɕiu˨
siu	ɕiu˥
siú	ɕiu˥˧
siù	ɕiu˨˩
siû	ɕiu˧˥
siū	ɕiu˧
--jir	ʑɨ˨
jir	ʑɨ˥
jír	ʑɨ˥˧
jìr	ʑɨ˨˩
jîr	ʑɨ˧˥
jīr	ʑɨ˧
--kai	kai˨
kai	kai˥
kái	kai˥˧
kài	kai˨˩
kâi	kai˧˥
kāi	kai˧
--kainn	kaĩ˨
kainn	kaĩ˥
káinn	kaĩ˥˧
kàinn	kaĩ˨˩
kâinn	kaĩ˧˥
kāinn	kaĩ˧
--khai	kʰai˨
khai	kʰai˥
khái	kʰai˥˧
khài	kʰai˨˩
khâi	kʰai˧˥
khāi	kʰai˧
--khainn	kʰaĩ˨
khainn	kʰaĩ˥
kháinn	kʰaĩ˥˧
khàinn	kʰaĩ˨˩
khâinn	kʰaĩ˧˥
khāinn	kʰaĩ˧
kah	kaʔ˩
ka̍h	kaʔ˥
--ka	ka˨
ka	ka˥
ká	ka˥˧
kà	ka˨˩
kâ	ka˧˥
kā	ka˧
--kann	kã˨
kann	kã˥
kánn	kã˥˧
kànn	kã˨˩
kânn	kã˧˥
kānn	kã˧
khah	kʰaʔ˩
kha̍h	kʰaʔ˥
--kha	kʰa˨
kha	kʰa˥
khá	kʰa˥˧
khà	kʰa˨˩
khâ	kʰa˧˥
khā	kʰa˧
--khann	kʰã˨
khann	kʰã˥
khánn	kʰã˥˧
khànn	kʰã˨˩
khânn	kʰã˧˥
khānn	kʰã˧
--khiau	kʰɪaʊ˨
khiau	kʰɪaʊ˥
khiáu	kʰɪaʊ˥˧
khiàu	kʰɪaʊ˨˩
khiâu	kʰɪaʊ˧˥
khiāu	kʰɪaʊ˧
--kiau	kɪaʊ˨
kiau	kɪaʊ˥
kiáu	kɪaʊ˥˧
kiàu	kɪaʊ˨˩
kiâu	kɪaʊ˧˥
kiāu	kɪaʊ˧
kak	kak˩
ka̍k	kak˥
khak	kʰak˩
kha̍k	kʰak˥
--kam	kam˨
kam	kam˥
kám	kam˥˧
kàm	kam˨˩
kâm	kam˧˥
kām	kam˧
--kham	kʰam˨
kham	kʰam˥
khám	kʰam˥˧
khàm	kʰam˨˩
khâm	kʰam˧˥
khām	kʰam˧
kap	kap˩
ka̍p	kap˥
khap	kʰap˩
kha̍p	kʰap˥
kat	kat˩
ka̍t	kat˥
khat	kʰat˩
kha̍t	kʰat˥
--kau	kau˨
kau	kau˥
káu	kau˥˧
kàu	kau˨˩
kâu	kau˧˥
kāu	kau˧
--khau	kʰau˨
khau	kʰau˥
kháu	kʰau˥˧
khàu	kʰau˨˩
khâu	kʰau˧˥
khāu	kʰau˧
--ke	ke˨
ke	ke˥
ké	ke˥˧
kè	ke˨˩
kê	ke˧˥
kē	ke˧
--kenn	kẽ˨
kenn	kẽ˥
kénn	kẽ˥˧
kènn	kẽ˨˩
kênn	kẽ˧˥
kēnn	kẽ˧
--khe	kʰe˨
khe	kʰe˥
khé	kʰe˥˧
khè	kʰe˨˩
khê	kʰe˧˥
khē	kʰe˧
--khenn	kʰẽ˨
khenn	kʰẽ˥
khénn	kʰẽ˥˧
khènn	kʰẽ˨˩
khênn	kʰẽ˧˥
khēnn	kʰẽ˧
khioh	kʰɪəʔ˩
khio̍h	kʰɪəʔ˥
--khio	kʰɪə˨
khio	kʰɪə˥
khió	kʰɪə˥˧
khiò	kʰɪə˨˩
khiô	kʰɪə˧˥
khiō	kʰɪə˧
--kho	kʰə˨
kho	kʰə˥
khó	kʰə˥˧
khò	kʰə˨˩
khô	kʰə˧˥
khō	kʰə˧
ik	ɪk˩
i̍k	ɪk˥
kioh	kɪəʔ˩
kio̍h	kɪəʔ˥
--kio	kɪə˨
kio	kɪə˥
kió	kɪə˥˧
kiò	kɪə˨˩
kiô	kɪə˧˥
kiō	kɪə˧
--ko	kə˨
ko	kə˥
kó	kə˥˧
kò	kə˨˩
kô	kə˧˥
kō	kə˧
--khian	kʰɪɛn˨
khian	kʰɪɛn˥
khián	kʰɪɛn˥˧
khiàn	kʰɪɛn˨˩
khiân	kʰɪɛn˧˥
khiān	kʰɪɛn˧
--kian	kɪɛn˨
kian	kɪɛn˥
kián	kɪɛn˥˧
kiàn	kɪɛn˨˩
kiân	kɪɛn˧˥
kiān	kɪɛn˧
--khi	kʰi˨
khi	kʰi˥
khí	kʰi˥˧
khì	kʰi˨˩
khî	kʰi˧˥
khī	kʰi˧
--khinn	kʰĩ˨
khinn	kʰĩ˥
khínn	kʰĩ˥˧
khìnn	kʰĩ˨˩
khînn	kʰĩ˧˥
khīnn	kʰĩ˧
--ki	ki˨
ki	ki˥
kí	ki˥˧
kì	ki˨˩
kî	ki˧˥
kī	ki˧
--kinn	kĩ˨
kinn	kĩ˥
kínn	kĩ˥˧
kìnn	kĩ˨˩
kînn	kĩ˧˥
kīnn	kĩ˧
--khim	kʰim˨
khim	kʰim˥
khím	kʰim˥˧
khìm	kʰim˨˩
khîm	kʰim˧˥
khīm	kʰim˧
--kim	kim˨
kim	kim˥
kím	kim˥˧
kìm	kim˨˩
kîm	kim˧˥
kīm	kim˧
--king	kiŋ˨
king	kiŋ˥
kíng	kiŋ˥˧
kìng	kiŋ˨˩
kîng	kiŋ˧˥
kīng	kiŋ˧
--khing	kʰiŋ˨
khing	kʰiŋ˥
khíng	kʰiŋ˥˧
khìng	kʰiŋ˨˩
khîng	kʰiŋ˧˥
khīng	kʰiŋ˧
--khin	kʰin˨
khin	kʰin˥
khín	kʰin˥˧
khìn	kʰin˨˩
khîn	kʰin˧˥
khīn	kʰin˧
--kin	kin˨
kin	kin˥
kín	kin˥˧
kìn	kin˨˩
kîn	kin˧˥
kīn	kin˧
khip	kʰip˩
khi̍p	kʰip˥
kip	kip˩
ki̍p	kip˥
khit	kʰit˩
khi̍t	kʰit˥
kit	kit˩
ki̍t	kit˥
khiô	kʰiu˧˥
khiō	kʰiu˧
--khiu	kʰiu˨
khiu	kʰiu˥
khiú	kʰiu˥˧
khiù	kʰiu˨˩
--khiunn	kʰiũ˨
khiunn	kʰiũ˥
khíúnn	kʰiũ˥˧
khìùnn	kʰiũ˨˩
khîûnn	kʰiũ˧˥
khīūnn	kʰiũ˧
kiô	kiu˧˥
kiō	kiu˧
--kiu	kiu˨
kiu	kiu˥
kiú	kiu˥˧
kiù	kiu˨˩
--kiunn	kiũ˨
kiunn	kiũ˥
kíúnn	kiũ˥˧
kìùnn	kiũ˨˩
kîûnn	kiũ˧˥
kīūnn	kiũ˧
jik	ʑɪk˩
ji̍k	ʑɪk˥
--khir	kʰɨ˨
khir	kʰɨ˥
khír	kʰɨ˥˧
khìr	kʰɨ˨˩
khîr	kʰɨ˧˥
khīr	kʰɨ˧
--kir	kɨ˨
kir	kɨ˥
kír	kɨ˥˧
kìr	kɨ˨˩
kîr	kɨ˧˥
kīr	kɨ˧
kik	kɪk˩
ki̍k	kɪk˥
khik	kʰɪk˩
khi̍k	kʰɪk˥
--khng	kʰŋ̍˨
khng	kʰŋ̍˥
khng	kʰŋ̍˥˧
khng	kʰŋ̍˨˩
khng	kʰŋ̍˧˥
khng	kʰŋ̍˧
--kng	kŋ̍˨
kng	kŋ̍˥
kng	kŋ̍˥˧
kng	kŋ̍˨˩
kng	kŋ̍˧˥
kng	kŋ̍˧
--kho	kʰo˨
kho	kʰo˥
khó	kʰo˥˧
khò	kʰo˨˩
khô	kʰo˧˥
khō	kʰo˧
--khoo	kʰɔ˨
khoo	kʰɔ˥
khóo	kʰɔ˥˧
khòo	kʰɔ˨˩
khôo	kʰɔ˧˥
khōo	kʰɔ˧
--khonn	kʰɔ̃˨
khonn	kʰɔ̃˥
khónn	kʰɔ̃˥˧
khònn	kʰɔ̃˨˩
khônn	kʰɔ̃˧˥
khōnn	kʰɔ̃˧
khiok	kʰɪɔk˩
khio̍k	kʰɪɔk˥
khok	kʰɔk˩
kho̍k	kʰɔk˥
kiok	kɪɔk˩
kio̍k	kɪɔk˥
kok	kɔk˩
ko̍k	kɔk˥
--ko	ko˨
ko	ko˥
kó	ko˥˧
kò	ko˨˩
kô	ko˧˥
kō	ko˧
--koo	kɔ˨
koo	kɔ˥
kóo	kɔ˥˧
kòo	kɔ˨˩
kôo	kɔ˧˥
kōo	kɔ˧
--konn	kɔ̃˨
konn	kɔ̃˥
kónn	kɔ̃˥˧
kònn	kɔ̃˨˩
kônn	kɔ̃˧˥
kōnn	kɔ̃˧
--khiong	kʰɪɔŋ˨
khiong	kʰɪɔŋ˥
khióng	kʰɪɔŋ˥˧
khiòng	kʰɪɔŋ˨˩
khiông	kʰɪɔŋ˧˥
khiōng	kʰɪɔŋ˧
--khong	kʰɔŋ˨
khong	kʰɔŋ˥
khóng	kʰɔŋ˥˧
khòng	kʰɔŋ˨˩
không	kʰɔŋ˧˥
khōng	kʰɔŋ˧
--kiong	kɪɔŋ˨
kiong	kɪɔŋ˥
kióng	kɪɔŋ˥˧
kiòng	kɪɔŋ˨˩
kiông	kɪɔŋ˧˥
kiōng	kɪɔŋ˧
--kong	kɔŋ˨
kong	kɔŋ˥
kóng	kɔŋ˥˧
kòng	kɔŋ˨˩
kông	kɔŋ˧˥
kōng	kɔŋ˧
sik	ɕɪk˩
si̍k	ɕɪk˥
--khuai	kʰuai˨
khuai	kʰuai˥
khuái	kʰuai˥˧
khuài	kʰuai˨˩
khuâi	kʰuai˧˥
khuāi	kʰuai˧
--kuai	kuai˨
kuai	kuai˥
kuái	kuai˥˧
kuài	kuai˨˩
kuâi	kuai˧˥
kuāi	kuai˧
--khua	kʰua˨
khua	kʰua˥
khuá	kʰua˥˧
khuà	kʰua˨˩
khuâ	kʰua˧˥
khuā	kʰua˧
--kua	kua˨
kua	kua˥
kuá	kua˥˧
kuà	kua˨˩
kuâ	kua˧˥
kuā	kua˧
--khuan	kʰuan˨
khuan	kʰuan˥
khuán	kʰuan˥˧
khuàn	kʰuan˨˩
khuân	kʰuan˧˥
khuān	kʰuan˧
--kuan	kuan˨
kuan	kuan˥
kuán	kuan˥˧
kuàn	kuan˨˩
kuân	kuan˧˥
kuān	kuan˧
--khue	kʰue˨
khue	kʰue˥
khué	kʰue˥˧
khuè	kʰue˨˩
khuê	kʰue˧˥
khuē	kʰue˧
--kue	kue˨
kue	kue˥
kué	kue˥˧
kuè	kue˨˩
kuê	kue˧˥
kuē	kue˧
--khu	kʰu˨
khu	kʰu˥
khú	kʰu˥˧
khù	kʰu˨˩
khû	kʰu˧˥
khū	kʰu˧
--ku	ku˨
ku	ku˥
kú	ku˥˧
kù	ku˨˩
kû	ku˧˥
kū	ku˧
--lai	lai˨
lai	lai˥
lái	lai˥˧
lài	lai˨˩
lâi	lai˧˥
lāi	lai˧
--lainn	laĩ˨
lainn	laĩ˥
láinn	laĩ˥˧
làinn	laĩ˨˩
lâinn	laĩ˧˥
lāinn	laĩ˧
lak	lak˩
la̍k	lak˥
lah	laʔ˩
la̍h	laʔ˥
--la	la˨
la	la˥
lá	la˥˧
là	la˨˩
lâ	la˧˥
lā	la˧
--lann	lã˨
lann	lã˥
lánn	lã˥˧
lànn	lã˨˩
lânn	lã˧˥
lānn	lã˧
--liau	lɪaʊ˨
liau	lɪaʊ˥
liáu	lɪaʊ˥˧
liàu	lɪaʊ˨˩
liâu	lɪaʊ˧˥
liāu	lɪaʊ˧
--lam	lam˨
lam	lam˥
lám	lam˥˧
làm	lam˨˩
lâm	lam˧˥
lām	lam˧
lap	lap˩
la̍p	lap˥
lat	lat˩
la̍t	lat˥
--lau	lau˨
lau	lau˥
láu	lau˥˧
làu	lau˨˩
lâu	lau˧˥
lāu	lau˧
--le	le˨
le	le˥
lé	le˥˧
lè	le˨˩
lê	le˧˥
lē	le˧
--lenn	lẽ˨
lenn	lẽ˥
lénn	lẽ˥˧
lènn	lẽ˨˩
lênn	lẽ˧˥
lēnn	lẽ˧
lioh	lɪəʔ˩
lio̍h	lɪəʔ˥
--lio	lɪə˨
lio	lɪə˥
lió	lɪə˥˧
liò	lɪə˨˩
liô	lɪə˧˥
liō	lɪə˧
--lo	lə˨
lo	lə˥
ló	lə˥˧
lò	lə˨˩
lô	lə˧˥
lō	lə˧
--lian	lɪɛn˨
lian	lɪɛn˥
lián	lɪɛn˥˧
liàn	lɪɛn˨˩
liân	lɪɛn˧˥
liān	lɪɛn˧
--li	li˨
li	li˥
lí	li˥˧
lì	li˨˩
lî	li˧˥
lī	li˧
--linn	lĩ˨
linn	lĩ˥
línn	lĩ˥˧
lìnn	lĩ˨˩
lînn	lĩ˧˥
līnn	lĩ˧
--lim	lim˨
lim	lim˥
lím	lim˥˧
lìm	lim˨˩
lîm	lim˧˥
līm	lim˧
--ling	liŋ˨
ling	liŋ˥
líng	liŋ˥˧
lìng	liŋ˨˩
lîng	liŋ˧˥
līng	liŋ˧
--lin	lin˨
lin	lin˥
lín	lin˥˧
lìn	lin˨˩
lîn	lin˧˥
līn	lin˧
lip	lip˩
li̍p	lip˥
liô	liu˧˥
liō	liu˧
--liu	liu˨
liu	liu˥
liú	liu˥˧
liù	liu˨˩
--liunn	liũ˨
liunn	liũ˥
líúnn	liũ˥˧
lìùnn	liũ˨˩
lîûnn	liũ˧˥
līūnn	liũ˧
lik	lɪk˩
li̍k	lɪk˥
--lir	lɨ˨
lir	lɨ˥
lír	lɨ˥˧
lìr	lɨ˨˩
lîr	lɨ˧˥
līr	lɨ˧
--lng	lŋ̍˨
lng	lŋ̍˥
lng	lŋ̍˥˧
lng	lŋ̍˨˩
lng	lŋ̍˧˥
lng	lŋ̍˧
liok	lɪɔk˩
lio̍k	lɪɔk˥
lok	lɔk˩
lo̍k	lɔk˥
--lo	lo˨
lo	lo˥
ló	lo˥˧
lò	lo˨˩
lô	lo˧˥
lō	lo˧
--loo	lɔ˨
loo	lɔ˥
lóo	lɔ˥˧
lòo	lɔ˨˩
lôo	lɔ˧˥
lōo	lɔ˧
--lonn	lɔ̃˨
lonn	lɔ̃˥
lónn	lɔ̃˥˧
lònn	lɔ̃˨˩
lônn	lɔ̃˧˥
lōnn	lɔ̃˧
--liong	lɪɔŋ˨
liong	lɪɔŋ˥
lióng	lɪɔŋ˥˧
liòng	lɪɔŋ˨˩
liông	lɪɔŋ˧˥
liōng	lɪɔŋ˧
--long	lɔŋ˨
long	lɔŋ˥
lóng	lɔŋ˥˧
lòng	lɔŋ˨˩
lông	lɔŋ˧˥
lōng	lɔŋ˧
--luai	luai˨
luai	luai˥
luái	luai˥˧
luài	luai˨˩
luâi	luai˧˥
luāi	luai˧
--lua	lua˨
lua	lua˥
luá	lua˥˧
luà	lua˨˩
luâ	lua˧˥
luā	lua˧
--luan	luan˨
luan	luan˥
luán	luan˥˧
luàn	luan˨˩
luân	luan˧˥
luān	luan˧
--lue	lue˨
lue	lue˥
lué	lue˥˧
luè	lue˨˩
luê	lue˧˥
luē	lue˧
--lu	lu˨
lu	lu˥
lú	lu˥˧
lù	lu˨˩
lû	lu˧˥
lū	lu˧
--mai	mai˨
mai	mai˥
mái	mai˥˧
mài	mai˨˩
mâi	mai˧˥
māi	mai˧
--mainn	maĩ˨
mainn	maĩ˥
máinn	maĩ˥˧
màinn	maĩ˨˩
mâinn	maĩ˧˥
māinn	maĩ˧
mak	mak˩
ma̍k	mak˥
mah	maʔ˩
ma̍h	maʔ˥
--ma	ma˨
ma	ma˥
má	ma˥˧
mà	ma˨˩
mâ	ma˧˥
mā	ma˧
--mann	mã˨
mann	mã˥
mánn	mã˥˧
mànn	mã˨˩
mânn	mã˧˥
mānn	mã˧
--mian	mɪaʊ˨
mian	mɪaʊ˥
mián	mɪaʊ˥˧
miàn	mɪaʊ˨˩
miân	mɪaʊ˧˥
miān	mɪaʊ˧
--mam	mam˨
mam	mam˥
mám	mam˥˧
màm	mam˨˩
mâm	mam˧˥
mām	mam˧
map	map˩
ma̍p	map˥
mat	mat˩
ma̍t	mat˥
--mau	mau˨
mau	mau˥
máu	mau˥˧
màu	mau˨˩
mâu	mau˧˥
māu	mau˧
--me	me˨
me	me˥
mé	me˥˧
mè	me˨˩
mê	me˧˥
mē	me˧
--menn	mẽ˨
menn	mẽ˥
ménn	mẽ˥˧
mènn	mẽ˨˩
mênn	mẽ˧˥
mēnn	mẽ˧
--mo	mə˨
mo	mə˥
mó	mə˥˧
mò	mə˨˩
mô	mə˧˥
mō	mə˧
--mian	mɪɛn˨
mian	mɪɛn˥
mián	mɪɛn˥˧
miàn	mɪɛn˨˩
miân	mɪɛn˧˥
miān	mɪɛn˧
--mi	mi˨
mi	mi˥
mí	mi˥˧
mì	mi˨˩
mî	mi˧˥
mī	mi˧
--minn	mĩ˨
minn	mĩ˥
mínn	mĩ˥˧
mìnn	mĩ˨˩
mînn	mĩ˧˥
mīnn	mĩ˧
--ming	miŋ˨
ming	miŋ˥
míng	miŋ˥˧
mìng	miŋ˨˩
mîng	miŋ˧˥
mīng	miŋ˧
--miunn	miũ˨
miunn	miũ˥
míúnn	miũ˥˧
mìùnn	miũ˨˩
mîûnn	miũ˧˥
mīūnn	miũ˧
mik	mɪk˩
mi̍k	mɪk˥
--mir	mɨ˨
mir	mɨ˥
mír	mɨ˥˧
mìr	mɨ˨˩
mîr	mɨ˧˥
mīr	mɨ˧
--m	m̩˨
m	m̩˥
ḿ	m̩˥˧
m	m̩˨˩
m	m̩˧˥
m	m̩˧
--mng	mŋ̍˨
mng	mŋ̍˥
mng	mŋ̍˥˧
mng	mŋ̍˨˩
mng	mŋ̍˧˥
mng	mŋ̍˧
mok	mɔk˩
mo̍k	mɔk˥
--mo	mo˨
mo	mo˥
mó	mo˥˧
mò	mo˨˩
mô	mo˧˥
mō	mo˧
--moo	mɔ˨
moo	mɔ˥
móo	mɔ˥˧
mòo	mɔ˨˩
môo	mɔ˧˥
mōo	mɔ˧
--monn	mɔ̃˨
monn	mɔ̃˥
mónn	mɔ̃˥˧
mònn	mɔ̃˨˩
mônn	mɔ̃˧˥
mōnn	mɔ̃˧
--mong	mɔŋ˨
mong	mɔŋ˥
móng	mɔŋ˥˧
mòng	mɔŋ˨˩
mông	mɔŋ˧˥
mōng	mɔŋ˧
--muai	muai˨
muai	muai˥
muái	muai˥˧
muài	muai˨˩
muâi	muai˧˥
muāi	muai˧
--mua	mua˨
mua	mua˥
muá	mua˥˧
muà	mua˨˩
muâ	mua˧˥
muā	mua˧
--muan	muan˨
muan	muan˥
muán	muan˥˧
muàn	muan˨˩
muân	muan˧˥
muān	muan˧
--mue	mue˨
mue	mue˥
mué	mue˥˧
muè	mue˨˩
muê	mue˧˥
muē	mue˧
--mu	mu˨
mu	mu˥
mú	mu˥˧
mù	mu˨˩
mû	mu˧˥
mū	mu˧
--nai	nai˨
nai	nai˥
nái	nai˥˧
nài	nai˨˩
nâi	nai˧˥
nāi	nai˧
--nainn	naĩ˨
nainn	naĩ˥
náinn	naĩ˥˧
nàinn	naĩ˨˩
nâinn	naĩ˧˥
nāinn	naĩ˧
nak	nak˩
na̍k	nak˥
--nam	nam˨
nam	nam˥
nám	nam˥˧
nàm	nam˨˩
nâm	nam˧˥
nām	nam˧
nah	naʔ˩
na̍h	naʔ˥
--na	na˨
na	na˥
ná	na˥˧
nà	na˨˩
nâ	na˧˥
nā	na˧
--nann	nã˨
nann	nã˥
nánn	nã˥˧
nànn	nã˨˩
nânn	nã˧˥
nānn	nã˧
--nian	nɪaʊ˨
nian	nɪaʊ˥
nián	nɪaʊ˥˧
niàn	nɪaʊ˨˩
niân	nɪaʊ˧˥
niān	nɪaʊ˧
nap	nap˩
na̍p	nap˥
nat	nat˩
na̍t	nat˥
--nau	nau˨
nau	nau˥
náu	nau˥˧
nàu	nau˨˩
nâu	nau˧˥
nāu	nau˧
--ne	ne˨
ne	ne˥
né	ne˥˧
nè	ne˨˩
nê	ne˧˥
nē	ne˧
--nenn	nẽ˨
nenn	nẽ˥
nénn	nẽ˥˧
nènn	nẽ˨˩
nênn	nẽ˧˥
nēnn	nẽ˧
--nian	nɪɛn˨
nian	nɪɛn˥
nián	nɪɛn˥˧
niàn	nɪɛn˨˩
niân	nɪɛn˧˥
niān	nɪɛn˧
--no	nə˨
no	nə˥
nó	nə˥˧
nò	nə˨˩
nô	nə˧˥
nō	nə˧
--ng	ŋ̍˨
ng	ŋ̍˥
ng	ŋ̍˥˧
ng	ŋ̍˨˩
ng	ŋ̍˧˥
ng	ŋ̍˧
--ning	niŋ˨
ning	niŋ˥
níng	niŋ˥˧
nìng	niŋ˨˩
nîng	niŋ˧˥
nīng	niŋ˧
--ni	ni˨
ni	ni˥
ní	ni˥˧
nì	ni˨˩
nî	ni˧˥
nī	ni˧
--ninn	nĩ˨
ninn	nĩ˥
nínn	nĩ˥˧
nìnn	nĩ˨˩
nînn	nĩ˧˥
nīnn	nĩ˧
--niunn	niũ˨
niunn	niũ˥
níúnn	niũ˥˧
nìùnn	niũ˨˩
nîûnn	niũ˧˥
nīūnn	niũ˧
nik	nɪk˩
ni̍k	nɪk˥
--nng	nŋ̍˨
nng	nŋ̍˥
nng	nŋ̍˥˧
nng	nŋ̍˨˩
nng	nŋ̍˧˥
nng	nŋ̍˧
--nir	nɨ˨
nir	nɨ˥
nír	nɨ˥˧
nìr	nɨ˨˩
nîr	nɨ˧˥
nīr	nɨ˧
nok	nɔk˩
no̍k	nɔk˥
--nong	nɔŋ˨
nong	nɔŋ˥
nóng	nɔŋ˥˧
nòng	nɔŋ˨˩
nông	nɔŋ˧˥
nōng	nɔŋ˧
--no	no˨
no	no˥
nó	no˥˧
nò	no˨˩
nô	no˧˥
nō	no˧
--noo	nɔ˨
noo	nɔ˥
nóo	nɔ˥˧
nòo	nɔ˨˩
nôo	nɔ˧˥
nōo	nɔ˧
--nonn	nɔ̃˨
nonn	nɔ̃˥
nónn	nɔ̃˥˧
nònn	nɔ̃˨˩
nônn	nɔ̃˧˥
nōnn	nɔ̃˧
--nuai	nuai˨
nuai	nuai˥
nuái	nuai˥˧
nuài	nuai˨˩
nuâi	nuai˧˥
nuāi	nuai˧
--nuan	nuan˨
nuan	nuan˥
nuán	nuan˥˧
nuàn	nuan˨˩
nuân	nuan˧˥
nuān	nuan˧
--nua	nua˨
nua	nua˥
nuá	nua˥˧
nuà	nua˨˩
nuâ	nua˧˥
nuā	nua˧
--nue	nue˨
nue	nue˥
nué	nue˥˧
nuè	nue˨˩
nuê	nue˧˥
nuē	nue˧
--nu	nu˨
nu	nu˥
nú	nu˥˧
nù	nu˨˩
nû	nu˧˥
nū	nu˧
iok	ɪɔk˩
io̍k	ɪɔk˥
ok	ɔk˩
o̍k	ɔk˥
--om	ɔm˨
om	ɔm˥
óm	ɔm˥˧
òm	ɔm˨˩
ôm	ɔm˧˥
ōm	ɔm˧
--iong	ɪɔŋ˨
iong	ɪɔŋ˥
ióng	ɪɔŋ˥˧
iòng	ɪɔŋ˨˩
iông	ɪɔŋ˧˥
iōng	ɪɔŋ˧
--jiong	ʑɪɔŋ˨
jiong	ʑɪɔŋ˥
jióng	ʑɪɔŋ˥˧
jiòng	ʑɪɔŋ˨˩
jiông	ʑɪɔŋ˧˥
jiōng	ʑɪɔŋ˧
--ong	ɔŋ˨
ong	ɔŋ˥
óng	ɔŋ˥˧
òng	ɔŋ˨˩
ông	ɔŋ˧˥
ōng	ɔŋ˧
--siong	ɕɪɔŋ˨
siong	ɕɪɔŋ˥
sióng	ɕɪɔŋ˥˧
siòng	ɕɪɔŋ˨˩
siông	ɕɪɔŋ˧˥
siông	ɕɪɔŋ˧˥
siōng	ɕɪɔŋ˧
--o	o˨
o	o˥
ó	o˥˧
ò	o˨˩
ô	o˧˥
ō	o˧
--oo	ɔ˨
oo	ɔ˥
óo	ɔ˥˧
òo	ɔ˨˩
ôo	ɔ˧˥
ōo	ɔ˧
--onn	ɔ̃˨
onn	ɔ̃˥
ónn	ɔ̃˥˧
ònn	ɔ̃˨˩
ônn	ɔ̃˧˥
ōnn	ɔ̃˧
--pai	pai˨
pai	pai˥
pái	pai˥˧
pài	pai˨˩
pâi	pai˧˥
pāi	pai˧
--painn	paĩ˨
painn	paĩ˥
páinn	paĩ˥˧
pàinn	paĩ˨˩
pâinn	paĩ˧˥
pāinn	paĩ˧
--phai	pʰai˨
phai	pʰai˥
phái	pʰai˥˧
phài	pʰai˨˩
phâi	pʰai˧˥
phāi	pʰai˧
--phainn	pʰaĩ˨
phainn	pʰaĩ˥
pháinn	pʰaĩ˥˧
phàinn	pʰaĩ˨˩
phâinn	pʰaĩ˧˥
phāinn	pʰaĩ˧
pak	pak˩
pa̍k	pak˥
phak	pʰak˩
pha̍k	pʰak˥
--pam	pam˨
pam	pam˥
pám	pam˥˧
pàm	pam˨˩
pâm	pam˧˥
pām	pam˧
--pham	pʰam˨
pham	pʰam˥
phám	pʰam˥˧
phàm	pʰam˨˩
phâm	pʰam˧˥
phām	pʰam˧
pah	paʔ˩
pa̍h	paʔ˥
--pa	pa˨
pa	pa˥
pá	pa˥˧
pà	pa˨˩
pâ	pa˧˥
pā	pa˧
--pann	pã˨
pann	pã˥
pánn	pã˥˧
pànn	pã˨˩
pânn	pã˧˥
pānn	pã˧
phah	pʰaʔ˩
pha̍h	pʰaʔ˥
--pha	pʰa˨
pha	pʰa˥
phá	pʰa˥˧
phà	pʰa˨˩
phâ	pʰa˧˥
phā	pʰa˧
--phann	pʰã˨
phann	pʰã˥
phánn	pʰã˥˧
phànn	pʰã˨˩
phânn	pʰã˧˥
phānn	pʰã˧
--phiau	pʰɪaʊ˨
phiau	pʰɪaʊ˥
phiáu	pʰɪaʊ˥˧
phiàu	pʰɪaʊ˨˩
phiâu	pʰɪaʊ˧˥
phiāu	pʰɪaʊ˧
--piau	pɪaʊ˨
piau	pɪaʊ˥
piáu	pɪaʊ˥˧
piàu	pɪaʊ˨˩
piâu	pɪaʊ˧˥
piāu	pɪaʊ˧
pap	pap˩
pa̍p	pap˥
phap	pʰap˩
pha̍p	pʰap˥
pat	pat˩
pa̍t	pat˥
phat	pʰat˩
pha̍t	pʰat˥
--pau	pau˨
pau	pau˥
páu	pau˥˧
pàu	pau˨˩
pâu	pau˧˥
pāu	pau˧
--phau	pʰau˨
phau	pʰau˥
pháu	pʰau˥˧
phàu	pʰau˨˩
phâu	pʰau˧˥
phāu	pʰau˧
--phian	pʰɪɛn˨
phian	pʰɪɛn˥
phián	pʰɪɛn˥˧
phiàn	pʰɪɛn˨˩
phiân	pʰɪɛn˧˥
phiān	pʰɪɛn˧
--pian	pɪɛn˨
pian	pɪɛn˥
pián	pɪɛn˥˧
piàn	pɪɛn˨˩
piân	pɪɛn˧˥
piān	pɪɛn˧
--pe	pe˨
pe	pe˥
pé	pe˥˧
pè	pe˨˩
pê	pe˧˥
pē	pe˧
--penn	pẽ˨
penn	pẽ˥
pénn	pẽ˥˧
pènn	pẽ˨˩
pênn	pẽ˧˥
pēnn	pẽ˧
--phe	pʰe˨
phe	pʰe˥
phé	pʰe˥˧
phè	pʰe˨˩
phê	pʰe˧˥
phē	pʰe˧
--phenn	pʰẽ˨
phenn	pʰẽ˥
phénn	pʰẽ˥˧
phènn	pʰẽ˨˩
phênn	pʰẽ˧˥
phēnn	pʰẽ˧
--phio	pʰɪə˨
phio	pʰɪə˥
phió	pʰɪə˥˧
phiò	pʰɪə˨˩
phiô	pʰɪə˧˥
phiō	pʰɪə˧
--pho	pʰə˨
pho	pʰə˥
phó	pʰə˥˧
phò	pʰə˨˩
phô	pʰə˧˥
phō	pʰə˧
--pio	pɪə˨
pio	pɪə˥
pió	pɪə˥˧
piò	pɪə˨˩
piô	pɪə˧˥
piō	pɪə˧
--po	pə˨
po	pə˥
pó	pə˥˧
pò	pə˨˩
pô	pə˧˥
pō	pə˧
--phim	pʰim˨
phim	pʰim˥
phím	pʰim˥˧
phìm	pʰim˨˩
phîm	pʰim˧˥
phīm	pʰim˧
--pim	pim˨
pim	pim˥
pím	pim˥˧
pìm	pim˨˩
pîm	pim˧˥
pīm	pim˧
--ping	piŋ˨
ping	piŋ˥
píng	piŋ˥˧
pìng	piŋ˨˩
pîng	piŋ˧˥
pīng	piŋ˧
--phing	pʰiŋ˨
phing	pʰiŋ˥
phíng	pʰiŋ˥˧
phìng	pʰiŋ˨˩
phîng	pʰiŋ˧˥
phīng	pʰiŋ˧
--phin	pʰin˨
phin	pʰin˥
phín	pʰin˥˧
phìn	pʰin˨˩
phîn	pʰin˧˥
phīn	pʰin˧
--pin	pin˨
pin	pin˥
pín	pin˥˧
pìn	pin˨˩
pîn	pin˧˥
pīn	pin˧
--phi	pʰi˨
phi	pʰi˥
phí	pʰi˥˧
phì	pʰi˨˩
phî	pʰi˧˥
phī	pʰi˧
--phinn	pʰĩ˨
phinn	pʰĩ˥
phínn	pʰĩ˥˧
phìnn	pʰĩ˨˩
phînn	pʰĩ˧˥
phīnn	pʰĩ˧
--pi	pi˨
pi	pi˥
pí	pi˥˧
pì	pi˨˩
pî	pi˧˥
pī	pi˧
--pinn	pĩ˨
pinn	pĩ˥
pínn	pĩ˥˧
pìnn	pĩ˨˩
pînn	pĩ˧˥
pīnn	pĩ˧
phit	pʰit˩
phi̍t	pʰit˥
pit	pit˩
pi̍t	pit˥
--phiunn	pʰiũ˨
phiunn	pʰiũ˥
phíúnn	pʰiũ˥˧
phìùnn	pʰiũ˨˩
phîûnn	pʰiũ˧˥
phīūnn	pʰiũ˧
piô	piu˧˥
piō	piu˧
--piu	piu˨
piu	piu˥
piú	piu˥˧
più	piu˨˩
--piunn	piũ˨
piunn	piũ˥
píúnn	piũ˥˧
pìùnn	piũ˨˩
pîûnn	piũ˧˥
pīūnn	piũ˧
pik	pɪk˩
pi̍k	pɪk˥
phik	pʰɪk˩
phi̍k	pʰɪk˥
--phng	pʰŋ̍˨
phng	pʰŋ̍˥
phng	pʰŋ̍˥˧
phng	pʰŋ̍˨˩
phng	pʰŋ̍˧˥
phng	pʰŋ̍˧
--png	pŋ̍˨
png	pŋ̍˥
png	pŋ̍˥˧
png	pŋ̍˨˩
png	pŋ̍˧˥
png	pŋ̍˧
phok	pʰɔk˩
pho̍k	pʰɔk˥
pok	pɔk˩
po̍k	pɔk˥
--phong	pʰɔŋ˨
phong	pʰɔŋ˥
phóng	pʰɔŋ˥˧
phòng	pʰɔŋ˨˩
phông	pʰɔŋ˧˥
phōng	pʰɔŋ˧
--pong	pɔŋ˨
pong	pɔŋ˥
póng	pɔŋ˥˧
pòng	pɔŋ˨˩
pông	pɔŋ˧˥
pōng	pɔŋ˧
--pho	pʰo˨
pho	pʰo˥
phó	pʰo˥˧
phò	pʰo˨˩
phô	pʰo˧˥
phō	pʰo˧
--phoo	pʰɔ˨
phoo	pʰɔ˥
phóo	pʰɔ˥˧
phòo	pʰɔ˨˩
phôo	pʰɔ˧˥
phōo	pʰɔ˧
--phonn	pʰɔ̃˨
phonn	pʰɔ̃˥
phónn	pʰɔ̃˥˧
phònn	pʰɔ̃˨˩
phônn	pʰɔ̃˧˥
phōnn	pʰɔ̃˧
--po	po˨
po	po˥
pó	po˥˧
pò	po˨˩
pô	po˧˥
pō	po˧
--poo	pɔ˨
poo	pɔ˥
póo	pɔ˥˧
pòo	pɔ˨˩
pôo	pɔ˧˥
pōo	pɔ˧
--ponn	pɔ̃˨
ponn	pɔ̃˥
pónn	pɔ̃˥˧
pònn	pɔ̃˨˩
pônn	pɔ̃˧˥
pōnn	pɔ̃˧
--phir	pʰɨ˨
phir	pʰɨ˥
phír	pʰɨ˥˧
phìr	pʰɨ˨˩
phîr	pʰɨ˧˥
phīr	pʰɨ˧
--pir	pɨ˨
pir	pɨ˥
pír	pɨ˥˧
pìr	pɨ˨˩
pîr	pɨ˧˥
pīr	pɨ˧
--phuai	pʰuai˨
phuai	pʰuai˥
phuái	pʰuai˥˧
phuài	pʰuai˨˩
phuâi	pʰuai˧˥
phuāi	pʰuai˧
--puai	puai˨
puai	puai˥
puái	puai˥˧
puài	puai˨˩
puâi	puai˧˥
puāi	puai˧
--phuan	pʰuan˨
phuan	pʰuan˥
phuán	pʰuan˥˧
phuàn	pʰuan˨˩
phuân	pʰuan˧˥
phuān	pʰuan˧
--puan	puan˨
puan	puan˥
puán	puan˥˧
puàn	puan˨˩
puân	puan˧˥
puān	puan˧
--phua	pʰua˨
phua	pʰua˥
phuá	pʰua˥˧
phuà	pʰua˨˩
phuâ	pʰua˧˥
phuā	pʰua˧
--pua	pua˨
pua	pua˥
puá	pua˥˧
puà	pua˨˩
puâ	pua˧˥
puā	pua˧
--phue	pʰue˨
phue	pʰue˥
phué	pʰue˥˧
phuè	pʰue˨˩
phuê	pʰue˧˥
phuē	pʰue˧
--pue	pue˨
pue	pue˥
pué	pue˥˧
puè	pue˨˩
puê	pue˧˥
puē	pue˧
--phu	pʰu˨
phu	pʰu˥
phú	pʰu˥˧
phù	pʰu˨˩
phû	pʰu˧˥
phū	pʰu˧
--pu	pu˨
pu	pu˥
pú	pu˥˧
pù	pu˨˩
pû	pu˧˥
pū	pu˧
--sai	sai˨
sai	sai˥
sái	sai˥˧
sài	sai˨˩
sâi	sai˧˥
sāi	sai˧
--sainn	saĩ˨
sainn	saĩ˥
sáinn	saĩ˥˧
sàinn	saĩ˨˩
sâinn	saĩ˧˥
sāinn	saĩ˧
sak	sak˩
sa̍k	sak˥
--sam	sam˨
sam	sam˥
sám	sam˥˧
sàm	sam˨˩
sâm	sam˧˥
sām	sam˧
sap	sap˩
sa̍p	sap˥
sah	saʔ˩
sa̍h	saʔ˥
--sa	sa˨
sa	sa˥
sá	sa˥˧
sà	sa˨˩
sâ	sa˧˥
sā	sa˧
--sann	sã˨
sann	sã˥
sánn	sã˥˧
sànn	sã˨˩
sânn	sã˧˥
sānn	sã˧
sat	sat˩
sa̍t	sat˥
--sau	sau˨
sau	sau˥
sáu	sau˥˧
sàu	sau˨˩
sâu	sau˧˥
sāu	sau˧
--sian	sɪɛn˨
sian	sɪɛn˥
sián	sɪɛn˥˧
siàn	sɪɛn˨˩
siân	sɪɛn˧˥
siān	sɪɛn˧
--se	se˨
se	se˥
sé	se˥˧
sè	se˨˩
sê	se˧˥
sē	se˧
--senn	sẽ˨
senn	sẽ˥
sénn	sẽ˥˧
sènn	sẽ˨˩
sênn	sẽ˧˥
sēnn	sẽ˧
sioh	sɪəʔ˩
sio̍h	sɪəʔ˥
--so	sə˨
so	sə˥
só	sə˥˧
sò	sə˨˩
sô	sə˧˥
sō	sə˧
--sim	sim˨
sim	sim˥
sím	sim˥˧
sìm	sim˨˩
sîm	sim˧˥
sīm	sim˧
--sing	siŋ˨
sing	siŋ˥
síng	siŋ˥˧
sìng	siŋ˨˩
sîng	siŋ˧˥
sīng	siŋ˧
sip	sip˩
si̍p	sip˥
--si	si˨
si	si˥
sí	si˥˧
sì	si˨˩
sî	si˧˥
sī	si˧
--sinn	sĩ˨
sinn	sĩ˥
sínn	sĩ˥˧
sìnn	sĩ˨˩
sînn	sĩ˧˥
sīnn	sĩ˧
sit	sit˩
si̍t	sit˥
--siunn	siũ˨
siunn	siũ˥
síúnn	siũ˥˧
sìùnn	siũ˨˩
sîûnn	siũ˧˥
sīūnn	siũ˧
sik	sɪk˩
si̍k	sɪk˥
--sng	sŋ̍˨
sng	sŋ̍˥
sng	sŋ̍˥˧
sng	sŋ̍˨˩
sng	sŋ̍˧˥
sng	sŋ̍˧
siok	sɪɔk˩
sio̍k	sɪɔk˥
sok	sɔk˩
so̍k	sɔk˥
--som	sɔm˨
som	sɔm˥
sóm	sɔm˥˧
sòm	sɔm˨˩
sôm	sɔm˧˥
sōm	sɔm˧
--song	sɔŋ˨
song	sɔŋ˥
sóng	sɔŋ˥˧
sòng	sɔŋ˨˩
sông	sɔŋ˧˥
sōng	sɔŋ˧
--so	so˨
so	so˥
só	so˥˧
sò	so˨˩
sô	so˧˥
sō	so˧
--soo	sɔ˨
soo	sɔ˥
sóo	sɔ˥˧
sòo	sɔ˨˩
sôo	sɔ˧˥
sōo	sɔ˧
--sonn	sɔ̃˨
sonn	sɔ̃˥
sónn	sɔ̃˥˧
sònn	sɔ̃˨˩
sônn	sɔ̃˧˥
sōnn	sɔ̃˧
--sir	sɨ˨
sir	sɨ˥
sír	sɨ˥˧
sìr	sɨ˨˩
sîr	sɨ˧˥
sīr	sɨ˧
--suai	suai˨
suai	suai˥
suái	suai˥˧
suài	suai˨˩
suâi	suai˧˥
suāi	suai˧
--suan	suan˨
suan	suan˥
suán	suan˥˧
suàn	suan˨˩
suân	suan˧˥
suān	suan˧
--sua	sua˨
sua	sua˥
suá	sua˥˧
suà	sua˨˩
suâ	sua˧˥
suā	sua˧
--sue	sue˨
sue	sue˥
sué	sue˥˧
suè	sue˨˩
suê	sue˧˥
suē	sue˧
--su	su˨
su	su˥
sú	su˥˧
sù	su˨˩
sû	su˧˥
sū	su˧
--tshiau	tɕʰɪaʊ˨
--tshiau	tɕʰɪaʊ˨
tshiau	tɕʰɪaʊ˥
tshiáu	tɕʰɪaʊ˥˧
tshiàu	tɕʰɪaʊ˨˩
tshiâu	tɕʰɪaʊ˧˥
tshiāu	tɕʰɪaʊ˧
--tsiau	tɕɪaʊ˨
tsiau	tɕɪaʊ˥
tsiáu	tɕɪaʊ˥˧
tsiàu	tɕɪaʊ˨˩
tsiâu	tɕɪaʊ˧˥
tsiāu	tɕɪaʊ˧
--tsai	tɕai˨
tsai	tɕai˥
tsái	tɕai˥˧
tsài	tɕai˨˩
tsâi	tɕai˧˥
tsāi	tɕai˧
--tsiainn	tɕaĩ˨
tsiainn	tɕaĩ˥
tsiáinn	tɕaĩ˥˧
tsiàinn	tɕaĩ˨˩
tsiâinn	tɕaĩ˧˥
tsiāinn	tɕaĩ˧
--tai	tai˨
tai	tai˥
tái	tai˥˧
tài	tai˨˩
tâi	tai˧˥
tāi	tai˧
--tainn	taĩ˨
tainn	taĩ˥
táinn	taĩ˥˧
tàinn	taĩ˨˩
tâinn	taĩ˧˥
tāinn	taĩ˧
--thai	tʰai˨
thai	tʰai˥
thái	tʰai˥˧
thài	tʰai˨˩
thâi	tʰai˧˥
thāi	tʰai˧
--thainn	tʰaĩ˨
thainn	tʰaĩ˥
tháinn	tʰaĩ˥˧
thàinn	tʰaĩ˨˩
thâinn	tʰaĩ˧˥
thāinn	tʰaĩ˧
tak	tak˩
ta̍k	tak˥
thak	tʰak˩
tha̍k	tʰak˥
--tam	tam˨
tam	tam˥
tám	tam˥˧
tàm	tam˨˩
tâm	tam˧˥
tām	tam˧
--tham	tʰam˨
tham	tʰam˥
thám	tʰam˥˧
thàm	tʰam˨˩
thâm	tʰam˧˥
thām	tʰam˧
tap	tap˩
ta̍p	tap˥
thap	tʰap˩
tha̍p	tʰap˥
tah	taʔ˩
ta̍h	taʔ˥
--ta	ta˨
ta	ta˥
tá	ta˥˧
tà	ta˨˩
tâ	ta˧˥
tā	ta˧
--tann	tã˨
tann	tã˥
tánn	tã˥˧
tànn	tã˨˩
tânn	tã˧˥
tānn	tã˧
thah	tʰaʔ˩
tha̍h	tʰaʔ˥
--tha	tʰa˨
tha	tʰa˥
thá	tʰa˥˧
thà	tʰa˨˩
thâ	tʰa˧˥
thā	tʰa˧
--thann	tʰã˨
thann	tʰã˥
thánn	tʰã˥˧
thànn	tʰã˨˩
thânn	tʰã˧˥
thānn	tʰã˧
--thiau	tʰɪaʊ˨
thiau	tʰɪaʊ˥
thiáu	tʰɪaʊ˥˧
thiàu	tʰɪaʊ˨˩
thiâu	tʰɪaʊ˧˥
thiāu	tʰɪaʊ˧
--tiau	tɪaʊ˨
tiau	tɪaʊ˥
tiáu	tɪaʊ˥˧
tiàu	tɪaʊ˨˩
tiâu	tɪaʊ˧˥
tiāu	tɪaʊ˧
tat	tat˩
ta̍t	tat˥
that	tʰat˩
tha̍t	tʰat˥
--tau	tau˨
tau	tau˥
táu	tau˥˧
tàu	tau˨˩
tâu	tau˧˥
tāu	tau˧
--thau	tʰau˨
thau	tʰau˥
tháu	tʰau˥˧
thàu	tʰau˨˩
thâu	tʰau˧˥
thāu	tʰau˧
--tsir	tɕɨ˨
tsir	tɕɨ˥
tsír	tɕɨ˥˧
tsìr	tɕɨ˨˩
tsîr	tɕɨ˧˥
tsīr	tɕɨ˧
--tshio	tɕʰɪə˨
tshio	tɕʰɪə˥
tshió	tɕʰɪə˥˧
tshiò	tɕʰɪə˨˩
tshiô	tɕʰɪə˧˥
tshiō	tɕʰɪə˧
tshioh	tɕʰɪəʔ˩
tshio̍h	tɕʰɪəʔ˥
tsioh	tɕɪəʔ˩
tsio̍h	tɕɪəʔ˥
--tshian	tɕʰɪɛn˨
tshian	tɕʰɪɛn˥
tshián	tɕʰɪɛn˥˧
tshiàn	tɕʰɪɛn˨˩
tshiân	tɕʰɪɛn˧˥
tshiān	tɕʰɪɛn˧
--tsian	tɕɪɛn˨
tsian	tɕɪɛn˥
tsián	tɕɪɛn˥˧
tsiàn	tɕɪɛn˨˩
tsiân	tɕɪɛn˧˥
tsiān	tɕɪɛn˧
--thian	tʰɪɛn˨
thian	tʰɪɛn˥
thián	tʰɪɛn˥˧
thiàn	tʰɪɛn˨˩
thiân	tʰɪɛn˧˥
thiān	tʰɪɛn˧
--tian	tɪɛn˨
tian	tɪɛn˥
tián	tɪɛn˥˧
tiàn	tɪɛn˨˩
tiân	tɪɛn˧˥
tiān	tɪɛn˧
--te	te˨
te	te˥
té	te˥˧
tè	te˨˩
tê	te˧˥
tē	te˧
--tenn	tẽ˨
tenn	tẽ˥
ténn	tẽ˥˧
tènn	tẽ˨˩
tênn	tẽ˧˥
tēnn	tẽ˧
--the	tʰe˨
the	tʰe˥
thé	tʰe˥˧
thè	tʰe˨˩
thê	tʰe˧˥
thē	tʰe˧
--thenn	tʰẽ˨
thenn	tʰẽ˥
thénn	tʰẽ˥˧
thènn	tʰẽ˨˩
thênn	tʰẽ˧˥
thēnn	tʰẽ˧
--thio	tʰɪə˨
thio	tʰɪə˥
thió	tʰɪə˥˧
thiò	tʰɪə˨˩
thiô	tʰɪə˧˥
thiō	tʰɪə˧
--tho	tʰə˨
tho	tʰə˥
thó	tʰə˥˧
thò	tʰə˨˩
thô	tʰə˧˥
thō	tʰə˧
tioh	tɪəʔ˩
tio̍h	tɪəʔ˥
--tio	tɪə˨
tio	tɪə˥
tió	tɪə˥˧
tiò	tɪə˨˩
tiô	tɪə˧˥
tiō	tɪə˧
--to	tə˨
to	tə˥
tó	tə˥˧
tò	tə˨˩
tô	tə˧˥
tō	tə˧
--tshia	tɕʰia˨
tshia	tɕʰia˥
tshiá	tɕʰia˥˧
tshià	tɕʰia˨˩
tshiâ	tɕʰia˧˥
tshiā	tɕʰia˧
--tshiann	tɕʰiã˨
tshiann	tɕʰiã˥
tshiánn	tɕʰiã˥˧
tshiànn	tɕʰiã˨˩
tshiânn	tɕʰiã˧˥
tshiānn	tɕʰiã˧
tshiah	tɕʰiaʔ˩
tshia̍h	tɕʰiaʔ˥
tsiah	tɕiaʔ˩
tsia̍h	tɕiaʔ˥
--tsia	tɕia˨
tsia	tɕia˥
tsiá	tɕia˥˧
tsià	tɕia˨˩
tsiâ	tɕia˧˥
tsiā	tɕia˧
--tsiann	tɕiã˨
tsiann	tɕiã˥
tsiánn	tɕiã˥˧
tsiànn	tɕiã˨˩
tsiânn	tɕiã˧˥
tsiānn	tɕiã˧
--tshiai	tɕʰiai˨
tshiai	tɕʰiai˥
tshiái	tɕʰiai˥˧
tshiài	tɕʰiai˨˩
tshiâi	tɕʰiai˧˥
tshiāi	tɕʰiai˧
--tshiainn	tɕʰiaĩ˨
tshiainn	tɕʰiaĩ˥
tshiáinn	tɕʰiaĩ˥˧
tshiàinn	tɕʰiaĩ˨˩
tshiâinn	tɕʰiaĩ˧˥
tshiāinn	tɕʰiaĩ˧
tshiak	tɕʰiak˩
tshia̍k	tɕʰiak˥
tsiak	tɕiak˩
tsia̍k	tɕiak˥
--tshiam	tɕʰiam˨
tshiam	tɕʰiam˥
tshiám	tɕʰiam˥˧
tshiàm	tɕʰiam˨˩
tshiâm	tɕʰiam˧˥
tshiām	tɕʰiam˧
--tsiam	tɕiam˨
tsiam	tɕiam˥
tsiám	tɕiam˥˧
tsiàm	tɕiam˨˩
tsiâm	tɕiam˧˥
tsiām	tɕiam˧
tshiap	tɕʰiap˩
tshia̍p	tɕʰiap˥
tsiap	tɕiap˩
tsia̍p	tɕiap˥
tshiat	tɕʰiat˩
tshia̍t	tɕʰiat˥
tsiat	tɕiat˩
tsia̍t	tɕiat˥
--tshi	tɕʰi˨
tshi	tɕʰi˥
tshí	tɕʰi˥˧
tshì	tɕʰi˨˩
tshî	tɕʰi˧˥
tshī	tɕʰi˧
--tshir	tɕʰiɨ˨
tshir	tɕʰiɨ˥
tshír	tɕʰiɨ˥˧
tshìr	tɕʰiɨ˨˩
tshîr	tɕʰiɨ˧˥
tshīr	tɕʰiɨ˧
--tsi	tɕi˨
tsi	tɕi˥
tsí	tɕi˥˧
tsì	tɕi˨˩
tsî	tɕi˧˥
tsī	tɕi˧
--tsinn	tɕĩ˨
tsinn	tɕĩ˥
tsínn	tɕĩ˥˧
tsìnn	tɕĩ˨˩
tsînn	tɕĩ˧˥
tsīnn	tɕĩ˧
--tshie	tɕʰie˨
tshie	tɕʰie˥
tshié	tɕʰie˥˧
tshiè	tɕʰie˨˩
tshiê	tɕʰie˧˥
tshiē	tɕʰie˧
--tshienn	tɕʰiẽ˨
tshienn	tɕʰiẽ˥
tshiénn	tɕʰiẽ˥˧
tshiènn	tɕʰiẽ˨˩
tshiênn	tɕʰiẽ˧˥
tshiēnn	tɕʰiẽ˧
--tshio	tɕʰiə˨
tshio	tɕʰiə˥
tshió	tɕʰiə˥˧
tshiò	tɕʰiə˨˩
tshiô	tɕʰiə˧˥
tshiō	tɕʰiə˧
--tsie	tɕie˨
tsie	tɕie˥
tsié	tɕie˥˧
tsiè	tɕie˨˩
tsiê	tɕie˧˥
tsiē	tɕie˧
--tsienn	tɕiẽ˨
tsienn	tɕiẽ˥
tsiénn	tɕiẽ˥˧
tsiènn	tɕiẽ˨˩
tsiênn	tɕiẽ˧˥
tsiēnn	tɕiẽ˧
--tsio	tɕiə˨
tsio	tɕiə˥
tsió	tɕiə˥˧
tsiò	tɕiə˨˩
tsiô	tɕiə˧˥
tsiō	tɕiə˧
--tshinn	tɕʰiĩ˨
tshinn	tɕʰiĩ˥
tshínn	tɕʰiĩ˥˧
tshìnn	tɕʰiĩ˨˩
tshînn	tɕʰiĩ˧˥
tshīnn	tɕʰiĩ˧
--tshiiunn	tɕʰiiũ˨
tshiiunn	tɕʰiiũ˥
tshííúnn	tɕʰiiũ˥˧
tshììùnn	tɕʰiiũ˨˩
tshîîûnn	tɕʰiiũ˧˥
tshīīūnn	tɕʰiiũ˧
--tshim	tɕʰim˨
tshim	tɕʰim˥
tshím	tɕʰim˥˧
tshìm	tɕʰim˨˩
tshîm	tɕʰim˧˥
tshīm	tɕʰim˧
--tsim	tɕim˨
tsim	tɕim˥
tsím	tɕim˥˧
tsìm	tɕim˨˩
tsîm	tɕim˧˥
tsīm	tɕim˧
--thim	tʰim˨
thim	tʰim˥
thím	tʰim˥˧
thìm	tʰim˨˩
thîm	tʰim˧˥
thīm	tʰim˧
--tim	tim˨
tim	tim˥
tím	tim˥˧
tìm	tim˨˩
tîm	tim˧˥
tīm	tim˧
--tshin	tɕʰin˨
tshin	tɕʰin˥
tshín	tɕʰin˥˧
tshìn	tɕʰin˨˩
tshîn	tɕʰin˧˥
tshīn	tɕʰin˧
--tshing	tɕʰiŋ˨
tshing	tɕʰiŋ˥
tshíng	tɕʰiŋ˥˧
tshìng	tɕʰiŋ˨˩
tshîng	tɕʰiŋ˧˥
tshīng	tɕʰiŋ˧
--tshing	tɕʰiŋ̍˨
tshing	tɕʰiŋ̍˥
tshíng	tɕʰiŋ̍˥˧
tshìng	tɕʰiŋ̍˨˩
tshîng	tɕʰiŋ̍˧˥
tshīng	tɕʰiŋ̍˧
--tsing	tɕiŋ˨
tsing	tɕiŋ˥
tsíng	tɕiŋ˥˧
tsìng	tɕiŋ˨˩
tsîng	tɕiŋ˧˥
tsīng	tɕiŋ˧
--tsing	tɕiŋ̍˨
tsing	tɕiŋ̍˥
tsíng	tɕiŋ̍˥˧
tsìng	tɕiŋ̍˨˩
tsîng	tɕiŋ̍˧˥
tsīng	tɕiŋ̍˧
--ting	tiŋ˨
ting	tiŋ˥
tíng	tiŋ˥˧
tìng	tiŋ˨˩
tîng	tiŋ˧˥
tīng	tiŋ˧
--thing	tʰiŋ˨
thing	tʰiŋ˥
thíng	tʰiŋ˥˧
thìng	tʰiŋ˨˩
thîng	tʰiŋ˧˥
thīng	tʰiŋ˧
--thin	tʰin˨
thin	tʰin˥
thín	tʰin˥˧
thìn	tʰin˨˩
thîn	tʰin˧˥
thīn	tʰin˧
--tin	tin˨
tin	tin˥
tín	tin˥˧
tìn	tin˨˩
tîn	tin˧˥
tīn	tin˧
--tshio	tɕʰio˨
tshio	tɕʰio˥
tshió	tɕʰio˥˧
tshiò	tɕʰio˨˩
tshiô	tɕʰio˧˥
tshiō	tɕʰio˧
--tshioo	tɕʰiɔ˨
tshioo	tɕʰiɔ˥
tshióo	tɕʰiɔ˥˧
tshiòo	tɕʰiɔ˨˩
tshiôo	tɕʰiɔ˧˥
tshiōo	tɕʰiɔ˧
--tshionn	tɕʰiɔ̃˨
tshionn	tɕʰiɔ̃˥
tshiónn	tɕʰiɔ̃˥˧
tshiònn	tɕʰiɔ̃˨˩
tshiônn	tɕʰiɔ̃˧˥
tshiōnn	tɕʰiɔ̃˧
--tsio	tɕio˨
tsio	tɕio˥
tsió	tɕio˥˧
tsiò	tɕio˨˩
tsiô	tɕio˧˥
tsiō	tɕio˧
--tsioo	tɕiɔ˨
tsioo	tɕiɔ˥
tsióo	tɕiɔ˥˧
tsiòo	tɕiɔ˨˩
tsiôo	tɕiɔ˧˥
tsiōo	tɕiɔ˧
--tsionn	tɕiɔ̃˨
tsionn	tɕiɔ̃˥
tsiónn	tɕiɔ̃˥˧
tsiònn	tɕiɔ̃˨˩
tsiônn	tɕiɔ̃˧˥
tsiōnn	tɕiɔ̃˧
tshiok	tɕʰiɔk˩
tshio̍k	tɕʰiɔk˥
tsiok	tɕiɔk˩
tsio̍k	tɕiɔk˥
tship	tɕʰip˩
tshi̍p	tɕʰip˥
tsip	tɕip˩
tsi̍p	tɕip˥
tshit	tɕʰit˩
tshi̍t	tɕʰit˥
tsit	tɕit˩
tsi̍t	tɕit˥
--thi	tʰi˨
thi	tʰi˥
thí	tʰi˥˧
thì	tʰi˨˩
thî	tʰi˧˥
thī	tʰi˧
--thinn	tʰĩ˨
thinn	tʰĩ˥
thínn	tʰĩ˥˧
thìnn	tʰĩ˨˩
thînn	tʰĩ˧˥
thīnn	tʰĩ˧
--ti	ti˨
ti	ti˥
tí	ti˥˧
tì	ti˨˩
tî	ti˧˥
tī	ti˧
--tinn	tĩ˨
tinn	tĩ˥
tínn	tĩ˥˧
tìnn	tĩ˨˩
tînn	tĩ˧˥
tīnn	tĩ˧
tit	tit˩
ti̍t	tit˥
--tshiua	tɕʰiua˨
tshiua	tɕʰiua˥
tshiuá	tɕʰiua˥˧
tshiuà	tɕʰiua˨˩
tshiuâ	tɕʰiua˧˥
tshiuā	tɕʰiua˧
--tshiuai	tɕʰiuai˨
tshiuai	tɕʰiuai˥
tshiuái	tɕʰiuai˥˧
tshiuài	tɕʰiuai˨˩
tshiuâi	tɕʰiuai˧˥
tshiuāi	tɕʰiuai˧
--tshiuan	tɕʰiuan˨
tshiuan	tɕʰiuan˥
tshiuán	tɕʰiuan˥˧
tshiuàn	tɕʰiuan˨˩
tshiuân	tɕʰiuan˧˥
tshiuān	tɕʰiuan˧
tshiô	tɕʰiu˧˥
tshiō	tɕʰiu˧
--tshiu	tɕʰiu˨
--tshiu	tɕʰiu˨
tshiu	tɕʰiu˥
tshiu	tɕʰiu˥
tshiú	tɕʰiu˥˧
tshiú	tɕʰiu˥˧
tshiù	tɕʰiu˨˩
tshiù	tɕʰiu˨˩
tshiû	tɕʰiu˧˥
tshiū	tɕʰiu˧
--tsiu	tɕiu˨
tsiu	tɕiu˥
tsiú	tɕiu˥˧
tsiù	tɕiu˨˩
tsiû	tɕiu˧˥
tsiū	tɕiu˧
--tsiiunn	tɕiũ˨
tsiiunn	tɕiũ˥
tsííúnn	tɕiũ˥˧
tsììùnn	tɕiũ˨˩
tsîîûnn	tɕiũ˧˥
tsīīūnn	tɕiũ˧
--tshiue	tɕʰiue˨
tshiue	tɕʰiue˥
tshiué	tɕʰiue˥˧
tshiuè	tɕʰiue˨˩
tshiuê	tɕʰiue˧˥
tshiuē	tɕʰiue˧
thiô	tʰiu˧˥
thiō	tʰiu˧
--thiu	tʰiu˨
thiu	tʰiu˥
thiú	tʰiu˥˧
thiù	tʰiu˨˩
--thiunn	tʰiũ˨
thiunn	tʰiũ˥
thíúnn	tʰiũ˥˧
thìùnn	tʰiũ˨˩
thîûnn	tʰiũ˧˥
thīūnn	tʰiũ˧
tiô	tiu˧˥
tiō	tiu˧
--tiu	tiu˨
tiu	tiu˥
tiú	tiu˥˧
tiù	tiu˨˩
--tiunn	tiũ˨
tiunn	tiũ˥
tíúnn	tiũ˥˧
tìùnn	tiũ˨˩
tîûnn	tiũ˧˥
tīūnn	tiũ˧
tshik	tɕʰɪk˩
tshi̍k	tɕʰɪk˥
tsik	tɕɪk˩
tsi̍k	tɕɪk˥
tik	tɪk˩
ti̍k	tɪk˥
thik	tʰɪk˩
thi̍k	tʰɪk˥
--thng	tʰŋ̍˨
thng	tʰŋ̍˥
thng	tʰŋ̍˥˧
thng	tʰŋ̍˨˩
thng	tʰŋ̍˧˥
thng	tʰŋ̍˧
--tng	tŋ̍˨
tng	tŋ̍˥
tng	tŋ̍˥˧
tng	tŋ̍˨˩
tng	tŋ̍˧˥
tng	tŋ̍˧
thiok	tʰɪɔk˩
thio̍k	tʰɪɔk˥
thok	tʰɔk˩
tho̍k	tʰɔk˥
tiok	tɪɔk˩
tio̍k	tɪɔk˥
tok	tɔk˩
to̍k	tɔk˥
--tom	tɔm˨
tom	tɔm˥
tóm	tɔm˥˧
tòm	tɔm˨˩
tôm	tɔm˧˥
tōm	tɔm˧
--tshiong	tɕʰɪɔŋ˨
tshiong	tɕʰɪɔŋ˥
tshióng	tɕʰɪɔŋ˥˧
tshiòng	tɕʰɪɔŋ˨˩
tshiông	tɕʰɪɔŋ˧˥
tshiōng	tɕʰɪɔŋ˧
--tsiong	tɕɪɔŋ˨
tsiong	tɕɪɔŋ˥
tsióng	tɕɪɔŋ˥˧
tsiòng	tɕɪɔŋ˨˩
tsiông	tɕɪɔŋ˧˥
tsiōng	tɕɪɔŋ˧
--thiong	tʰɪɔŋ˨
thiong	tʰɪɔŋ˥
thióng	tʰɪɔŋ˥˧
thiòng	tʰɪɔŋ˨˩
thiông	tʰɪɔŋ˧˥
thiōng	tʰɪɔŋ˧
--thong	tʰɔŋ˨
thong	tʰɔŋ˥
thóng	tʰɔŋ˥˧
thòng	tʰɔŋ˨˩
thông	tʰɔŋ˧˥
thōng	tʰɔŋ˧
--tiong	tɪɔŋ˨
tiong	tɪɔŋ˥
tióng	tɪɔŋ˥˧
tiòng	tɪɔŋ˨˩
tiông	tɪɔŋ˧˥
tiōng	tɪɔŋ˧
--tong	tɔŋ˨
tong	tɔŋ˥
tóng	tɔŋ˥˧
tòng	tɔŋ˨˩
tông	tɔŋ˧˥
tōng	tɔŋ˧
--tho	tʰo˨
tho	tʰo˥
thó	tʰo˥˧
thò	tʰo˨˩
thô	tʰo˧˥
thō	tʰo˧
--thoo	tʰɔ˨
thoo	tʰɔ˥
thóo	tʰɔ˥˧
thòo	tʰɔ˨˩
thôo	tʰɔ˧˥
thōo	tʰɔ˧
--thonn	tʰɔ̃˨
thonn	tʰɔ̃˥
thónn	tʰɔ̃˥˧
thònn	tʰɔ̃˨˩
thônn	tʰɔ̃˧˥
thōnn	tʰɔ̃˧
--to	to˨
to	to˥
tó	to˥˧
tò	to˨˩
tô	to˧˥
tō	to˧
--too	tɔ˨
too	tɔ˥
tóo	tɔ˥˧
tòo	tɔ˨˩
tôo	tɔ˧˥
tōo	tɔ˧
--tonn	tɔ̃˨
tonn	tɔ̃˥
tónn	tɔ̃˥˧
tònn	tɔ̃˨˩
tônn	tɔ̃˧˥
tōnn	tɔ̃˧
tsah	tsaʔ˩
tsa̍h	tsaʔ˥
--tsa	tsa˨
tsa	tsa˥
tsá	tsa˥˧
tsà	tsa˨˩
tsâ	tsa˧˥
tsā	tsa˧
--tsann	tsã˨
tsann	tsã˥
tsánn	tsã˥˧
tsànn	tsã˨˩
tsânn	tsã˧˥
tsānn	tsã˧
--tsha	tsʰa˨
tsha	tsʰa˥
tshá	tsʰa˥˧
tshà	tsʰa˨˩
tshâ	tsʰa˧˥
tshā	tsʰa˧
--tshann	tsʰã˨
tshann	tsʰã˥
tshánn	tsʰã˥˧
tshànn	tsʰã˨˩
tshânn	tsʰã˧˥
tshānn	tsʰã˧
tshah	tsʰaʔ˩
tsha̍h	tsʰaʔ˥
--tsiau	tsɪaʊ˨
tsiau	tsɪaʊ˥
tsiáu	tsɪaʊ˥˧
tsiàu	tsɪaʊ˨˩
tsiâu	tsɪaʊ˧˥
tsiāu	tsɪaʊ˧
--tsai	tsai˨
tsai	tsai˥
tsái	tsai˥˧
tsài	tsai˨˩
tsâi	tsai˧˥
tsāi	tsai˧
--tsainn	tsaĩ˨
tsainn	tsaĩ˥
tsáinn	tsaĩ˥˧
tsàinn	tsaĩ˨˩
tsâinn	tsaĩ˧˥
tsāinn	tsaĩ˧
--tshai	tsʰai˨
tshai	tsʰai˥
tshái	tsʰai˥˧
tshài	tsʰai˨˩
tshâi	tsʰai˧˥
tshāi	tsʰai˧
--tshainn	tsʰaĩ˨
tshainn	tsʰaĩ˥
tsháinn	tsʰaĩ˥˧
tshàinn	tsʰaĩ˨˩
tshâinn	tsʰaĩ˧˥
tshāinn	tsʰaĩ˧
tsak	tsak˩
tsa̍k	tsak˥
tshak	tsʰak˩
tsha̍k	tsʰak˥
--tsam	tsam˨
tsam	tsam˥
tsám	tsam˥˧
tsàm	tsam˨˩
tsâm	tsam˧˥
tsām	tsam˧
--tsham	tsʰam˨
tsham	tsʰam˥
tshám	tsʰam˥˧
tshàm	tsʰam˨˩
tshâm	tsʰam˧˥
tshām	tsʰam˧
tsap	tsap˩
tsa̍p	tsap˥
tshap	tsʰap˩
tsha̍p	tsʰap˥
tsat	tsat˩
tsa̍t	tsat˥
tshat	tsʰat˩
tsha̍t	tsʰat˥
--tsau	tsau˨
tsau	tsau˥
tsáu	tsau˥˧
tsàu	tsau˨˩
tsâu	tsau˧˥
tsāu	tsau˧
--tshau	tsʰau˨
tshau	tsʰau˥
tsháu	tsʰau˥˧
tshàu	tsʰau˨˩
tshâu	tsʰau˧˥
tshāu	tsʰau˧
--tshir	tsʰɨ˨
tshir	tsʰɨ˥
tshír	tsʰɨ˥˧
tshìr	tsʰɨ˨˩
tshîr	tsʰɨ˧˥
tshīr	tsʰɨ˧
--tsir	tsɨ˨
tsir	tsɨ˥
tsír	tsɨ˥˧
tsìr	tsɨ˨˩
tsîr	tsɨ˧˥
tsīr	tsɨ˧
--tse	tse˨
tse	tse˥
tsé	tse˥˧
tsè	tse˨˩
tsê	tse˧˥
tsē	tse˧
--tsenn	tsẽ˨
tsenn	tsẽ˥
tsénn	tsẽ˥˧
tsènn	tsẽ˨˩
tsênn	tsẽ˧˥
tsēnn	tsẽ˧
--tshe	tsʰe˨
tshe	tsʰe˥
tshé	tsʰe˥˧
tshè	tsʰe˨˩
tshê	tsʰe˧˥
tshē	tsʰe˧
--tshenn	tsʰẽ˨
tshenn	tsʰẽ˥
tshénn	tsʰẽ˥˧
tshènn	tsʰẽ˨˩
tshênn	tsʰẽ˧˥
tshēnn	tsʰẽ˧
--tsho	tsʰə˨
tsho	tsʰə˥
tshó	tsʰə˥˧
tshò	tsʰə˨˩
tshô	tsʰə˧˥
tshō	tsʰə˧
--tsio	tsɪə˨
tsio	tsɪə˥
tsió	tsɪə˥˧
tsiò	tsɪə˨˩
tsiô	tsɪə˧˥
tsiō	tsɪə˧
--tso	tsə˨
tso	tsə˥
tsó	tsə˥˧
tsò	tsə˨˩
tsô	tsə˧˥
tsō	tsə˧
--tshian	tsʰɪɛn˨
tshian	tsʰɪɛn˥
tshián	tsʰɪɛn˥˧
tshiàn	tsʰɪɛn˨˩
tshiân	tsʰɪɛn˧˥
tshiān	tsʰɪɛn˧
--tsian	tsɪɛn˨
tsian	tsɪɛn˥
tsián	tsɪɛn˥˧
tsiàn	tsɪɛn˨˩
tsiân	tsɪɛn˧˥
tsiān	tsɪɛn˧
--tshi	tsʰi˨
tshi	tsʰi˥
tshí	tsʰi˥˧
tshì	tsʰi˨˩
tshî	tsʰi˧˥
tshī	tsʰi˧
--tshinn	tsʰĩ˨
tshinn	tsʰĩ˥
tshínn	tsʰĩ˥˧
tshìnn	tsʰĩ˨˩
tshînn	tsʰĩ˧˥
tshīnn	tsʰĩ˧
--tsi	tsi˨
tsi	tsi˥
tsí	tsi˥˧
tsì	tsi˨˩
tsî	tsi˧˥
tsī	tsi˧
--tsinn	tsĩ˨
tsinn	tsĩ˥
tsínn	tsĩ˥˧
tsìnn	tsĩ˨˩
tsînn	tsĩ˧˥
tsīnn	tsĩ˧
--tshim	tsʰim˨
tshim	tsʰim˥
tshím	tsʰim˥˧
tshìm	tsʰim˨˩
tshîm	tsʰim˧˥
tshīm	tsʰim˧
--tsim	tsim˨
tsim	tsim˥
tsím	tsim˥˧
tsìm	tsim˨˩
tsîm	tsim˧˥
tsīm	tsim˧
--tsin	tsin˨
tsin	tsin˥
tsín	tsin˥˧
tsìn	tsin˨˩
tsîn	tsin˧˥
tsīn	tsin˧
--tsing	tsiŋ˨
tsing	tsiŋ˥
tsíng	tsiŋ˥˧
tsìng	tsiŋ˨˩
tsîng	tsiŋ˧˥
tsīng	tsiŋ˧
--tshing	tsʰiŋ˨
tshing	tsʰiŋ˥
tshíng	tsʰiŋ˥˧
tshìng	tsʰiŋ˨˩
tshîng	tsʰiŋ˧˥
tshīng	tsʰiŋ˧
--tshiunn	tsʰiũ˨
tshiunn	tsʰiũ˥
tshíúnn	tsʰiũ˥˧
tshìùnn	tsʰiũ˨˩
tshîûnn	tsʰiũ˧˥
tshīūnn	tsʰiũ˧
tsiô	tsiu˧˥
tsiō	tsiu˧
--tsiu	tsiu˨
tsiu	tsiu˥
tsiú	tsiu˥˧
tsiù	tsiu˨˩
--tsiunn	tsiũ˨
tsiunn	tsiũ˥
tsíúnn	tsiũ˥˧
tsìùnn	tsiũ˨˩
tsîûnn	tsiũ˧˥
tsīūnn	tsiũ˧
tsik	tsɪk˩
tsi̍k	tsɪk˥
tshik	tsʰɪk˩
tshi̍k	tsʰɪk˥
--tshng	tsʰŋ̍˨
tshng	tsʰŋ̍˥
tshng	tsʰŋ̍˥˧
tshng	tsʰŋ̍˨˩
tshng	tsʰŋ̍˧˥
tshng	tsʰŋ̍˧
--tsng	tsŋ̍˨
tsng	tsŋ̍˥
tsng	tsŋ̍˥˧
tsng	tsŋ̍˨˩
tsng	tsŋ̍˧˥
tsng	tsŋ̍˧
--tsho	tsʰo˨
tsho	tsʰo˥
tshó	tsʰo˥˧
tshò	tsʰo˨˩
tshô	tsʰo˧˥
tshō	tsʰo˧
--tshoo	tsʰɔ˨
tshoo	tsʰɔ˥
tshóo	tsʰɔ˥˧
tshòo	tsʰɔ˨˩
tshôo	tsʰɔ˧˥
tshōo	tsʰɔ˧
--tshonn	tsʰɔ̃˨
tshonn	tsʰɔ̃˥
tshónn	tsʰɔ̃˥˧
tshònn	tsʰɔ̃˨˩
tshônn	tsʰɔ̃˧˥
tshōnn	tsʰɔ̃˧
--tso	tso˨
tso	tso˥
tsó	tso˥˧
tsò	tso˨˩
tsô	tso˧˥
tsō	tso˧
--tsoo	tsɔ˨
tsoo	tsɔ˥
tsóo	tsɔ˥˧
tsòo	tsɔ˨˩
tsôo	tsɔ˧˥
tsōo	tsɔ˧
--tsonn	tsɔ̃˨
tsonn	tsɔ̃˥
tsónn	tsɔ̃˥˧
tsònn	tsɔ̃˨˩
tsônn	tsɔ̃˧˥
tsōnn	tsɔ̃˧
tshok	tsʰɔk˩
tsho̍k	tsʰɔk˥
tsok	tsɔk˩
tso̍k	tsɔk˥
--tshong	tsʰɔŋ˨
tshong	tsʰɔŋ˥
tshóng	tsʰɔŋ˥˧
tshòng	tsʰɔŋ˨˩
tshông	tsʰɔŋ˧˥
tshōng	tsʰɔŋ˧
--tsong	tsɔŋ˨
tsong	tsɔŋ˥
tsóng	tsɔŋ˥˧
tsòng	tsɔŋ˨˩
tsông	tsɔŋ˧˥
tsōng	tsɔŋ˧
--tshua	tsʰua˨
tshua	tsʰua˥
tshuá	tsʰua˥˧
tshuà	tsʰua˨˩
tshuâ	tsʰua˧˥
tshuā	tsʰua˧
--tsua	tsua˨
tsua	tsua˥
tsuá	tsua˥˧
tsuà	tsua˨˩
tsuâ	tsua˧˥
tsuā	tsua˧
--tshuai	tsʰuai˨
tshuai	tsʰuai˥
tshuái	tsʰuai˥˧
tshuài	tsʰuai˨˩
tshuâi	tsʰuai˧˥
tshuāi	tsʰuai˧
--tsuai	tsuai˨
tsuai	tsuai˥
tsuái	tsuai˥˧
tsuài	tsuai˨˩
tsuâi	tsuai˧˥
tsuāi	tsuai˧
--tshuan	tsʰuan˨
tshuan	tsʰuan˥
tshuán	tsʰuan˥˧
tshuàn	tsʰuan˨˩
tshuân	tsʰuan˧˥
tshuān	tsʰuan˧
--tsuan	tsuan˨
tsuan	tsuan˥
tsuán	tsuan˥˧
tsuàn	tsuan˨˩
tsuân	tsuan˧˥
tsuān	tsuan˧
--tshu	tsʰu˨
tshu	tsʰu˥
tshú	tsʰu˥˧
tshù	tsʰu˨˩
tshû	tsʰu˧˥
tshū	tsʰu˧
--tsu	tsu˨
tsu	tsu˥
tsú	tsu˥˧
tsù	tsu˨˩
tsû	tsu˧˥
tsū	tsu˧
--tshue	tsʰue˨
tshue	tsʰue˥
tshué	tsʰue˥˧
tshuè	tsʰue˨˩
tshuê	tsʰue˧˥
tshuē	tsʰue˧
--tsue	tsue˨
tsue	tsue˥
tsué	tsue˥˧
tsuè	tsue˨˩
tsuê	tsue˧˥
tsuē	tsue˧
--thir	tʰɨ˨
thir	tʰɨ˥
thír	tʰɨ˥˧
thìr	tʰɨ˨˩
thîr	tʰɨ˧˥
thīr	tʰɨ˧
--tir	tɨ˨
tir	tɨ˥
tír	tɨ˥˧
tìr	tɨ˨˩
tîr	tɨ˧˥
tīr	tɨ˧
--tsua	tɕua˨
tsua	tɕua˥
tsuá	tɕua˥˧
tsuà	tɕua˨˩
tsuâ	tɕua˧˥
tsuā	tɕua˧
--tsuai	tɕuai˨
tsuai	tɕuai˥
tsuái	tɕuai˥˧
tsuài	tɕuai˨˩
tsuâi	tɕuai˧˥
tsuāi	tɕuai˧
--thuai	tʰuai˨
thuai	tʰuai˥
thuái	tʰuai˥˧
thuài	tʰuai˨˩
thuâi	tʰuai˧˥
thuāi	tʰuai˧
--tuai	tuai˨
tuai	tuai˥
tuái	tuai˥˧
tuài	tuai˨˩
tuâi	tuai˧˥
tuāi	tuai˧
--tsuan	tɕuan˨
tsuan	tɕuan˥
tsuán	tɕuan˥˧
tsuàn	tɕuan˨˩
tsuân	tɕuan˧˥
tsuān	tɕuan˧
--thuan	tʰuan˨
thuan	tʰuan˥
thuán	tʰuan˥˧
thuàn	tʰuan˨˩
thuân	tʰuan˧˥
thuān	tʰuan˧
--tuan	tuan˨
tuan	tuan˥
tuán	tuan˥˧
tuàn	tuan˨˩
tuân	tuan˧˥
tuān	tuan˧
--thua	tʰua˨
thua	tʰua˥
thuá	tʰua˥˧
thuà	tʰua˨˩
thuâ	tʰua˧˥
thuā	tʰua˧
--tua	tua˨
tua	tua˥
tuá	tua˥˧
tuà	tua˨˩
tuâ	tua˧˥
tuā	tua˧
--tsue	tɕue˨
tsue	tɕue˥
tsué	tɕue˥˧
tsuè	tɕue˨˩
tsuê	tɕue˧˥
tsuē	tɕue˧
--thue	tʰue˨
thue	tʰue˥
thué	tʰue˥˧
thuè	tʰue˨˩
thuê	tʰue˧˥
thuē	tʰue˧
--tue	tue˨
tue	tue˥
tué	tue˥˧
tuè	tue˨˩
tuê	tue˧˥
tuē	tue˧
--thu	tʰu˨
thu	tʰu˥
thú	tʰu˥˧
thù	tʰu˨˩
thû	tʰu˧˥
thū	tʰu˧
--tu	tu˨
tu	tu˥
tú	tu˥˧
tù	tu˨˩
tû	tu˧˥
tū	tu˧
--uai	uai˨
uai	uai˥
uái	uai˥˧
uài	uai˨˩
uâi	uai˧˥
uāi	uai˧
--suai	ɕuai˨
suai	ɕuai˥
suái	ɕuai˥˧
suài	ɕuai˨˩
suâi	ɕuai˧˥
suāi	ɕuai˧
--uan	uan˨
uan	uan˥
uán	uan˥˧
uàn	uan˨˩
uân	uan˧˥
uān	uan˧
--ua	ua˨
ua	ua˥
uá	ua˥˧
uà	ua˨˩
uâ	ua˧˥
uā	ua˧
--jue	ʑue˨
jue	ʑue˥
jué	ʑue˥˧
juè	ʑue˨˩
juê	ʑue˧˥
juē	ʑue˧
--ue	ue˨
ue	ue˥
ué	ue˥˧
uè	ue˨˩
uê	ue˧˥
uē	ue˧
--u	u˨
u	u˥
ú	u˥˧
ù	u˨˩
û	u˧˥
ū	u˧
